--------------------------------------------------------------------------------------------------------------------------------------------------------------------------------------------------------
---------------o----------oEoo--------------o---------o-------X-----o----Bo-M-----o--------------o-o---o-----------oo-o-------B---B-------o-----o-----o------------------------------------X------------
------------------X-----B-XM----------o------------o-----B-----o-E--o--oM-E------------Bo-----o-B----------------oo-----X------o---------o--------?----EE-o--?-ooo-Eo-M-----------M---------o-----------
------------o?o--o----------o-o-oo-o-B-E--M------E-M------oo----BBE-------B-----T--X-----o---Xoo----o-----B--------B-M-----------X-o------o----?-oo--X-BM-o--o----XBE?o----o--Boo-----------------------
---------?o---B----o-----o--------o----T---X---M-XX------------X--X---B--Xo--o--|--o-o-o--X-----E-B------o----------o--o--X-oo--------X--TB-----------X--M----------B-o---oo----------------------o-----
------------------o--XM---?------------|----------------X--------------M-oo---oM|----X---B----EXX--M----?B------o-o-----------o-oo-----X-|--o------------------o-----o---------E------X-o------o?o------
---------B-----------------B--o-----X--|o----------------------E-ooM-------o--X-|----oXB---o--M---o-B-XE-------M------------o------------|-X-o--------o-?------B-----o?--o-----?------o---o-------------
-------X---o-B-----Eo----------X-----E-|-oo-EX----o-Bo---X--B--ME----M--Eo------X--oo---------------o--T--o--MB-----?--------o--BE-------|------------------oXo-XE-----o---T------o-o----o-oo-----M----v
---------o--T------T----o----?---o--oM-|----T-------------------B-X-----MX---oo----Eo-----o---o------o-|----B---oTo--------------M-M-o---|-------o---X----------o?---X-----|---o?----M-?---X------M----f
----------?-|-----X|-B---M--o------o-oE|o---|o------o-----M-o---------Xoo---------M?-------------B-----|-?-------|-------o-M-E------?----|X-o-----------E---------o-----o--|-oo-o--X-o---------Xo------f
-------X----|--oo--|-o----o--------o-oM|-oB-|-B--M----------o-M----E-B--o--T---------o--o-------------B|o--E-----|-----o-----?-M---------X--------oo----X----ME---o---B--B-|--------------M----o-------f
---B------Eo|M-o-X-|----------------o--|-o--X----o-oE--B--------o--X----o--|---------o---------M-E-oo--|B-MB---Bo|B-X-B--o--------X--o-----------------E------?----------o-|-------o-o--Eo-------------f
--M-ooBo--B-|------|-o---M-----o---X---|o----------oXXo--?o----Mo---B--o-o-|-B---o-o-------------M-----|---------|-Bo----T--o-o------------------oM-o--X-------------------|--BT--o-----B----?----T----f
------------|----o-|-o-----------------|o------------------o-----o---------|o-----------o---------o-o--|--------o|---o--o|o------o-o------------o-o-o-o-o----o-------------|---|o-o----------o---o|----f
m-----o---o-|----E-|EoEEo-ooo----o--o--|---EE---------o-E--o--E-o-o-------o|-o-------------------oo----|---------|--Eo---|------o---o-----o-------------------o---oE-E--o--|-oE|------------------|----X
XXXXXXXXXXXXX----XXXXXXXXXXXXX---XXXXXXXXXXXXXXXXX-XXXXXXXXXXXXXXXX----XXXXXXXX--XXX-X-XXXX-XX-XXXXXXXX|--X--XX-XXXXXX--XXXXXXX-XXXXXXX-X-XXXXX-XXXXXXXXXX---XXXX-XXXXXXXXXX-XX|XXXXXXXX---XXXXXXX|X-XXX
