------O--O---O-O--O--O-------OO----O-EOEEO--O-OO---O-OO-OOOO-O---OO----OO--O---------------O-O---O-----O--O-O---O------E------OEO------OO-----O----O-O-OO-O----O-OO--O--OOEO-O---O--O-O--OO--O--E---OO-O
-----O----OEEO-MB-XO--OO-O-OXOO--O-OBBOMB-OB-BOO--O-?E-O--EX----OOOEO-X-OO-B-O-OO-O---OOOO-O-OO--O--E--OT-O-O------O--O?OOOX-O-M-BO---OOOO------?O-BOEO----O-?O-OO-OO----BBOT-OOOO-OO----O-EEOOMMBO-?OO-
-OOO--O--XOBBO-O---O--O-OX--OO-B-O-----XOOO-OOO-O---OBO-ETBOOO----O?--O-O---XOMXX-E---X-O-OO-O-E-OOOT--O|OXMBB---XB---OO-O-B-O-O--OO--OX---OXMBO--O--B-O---OO-OO--B----E?O-X|XO--TBO-OM----XXOOO----O-OO
--O-O--O---OOBO-EEO--B?-XOOO--O---M--OO-O-T-OE-X----OO-OT|-O-MBT-O-OBX-X--O--MO-O-M----O-X-B--OBO-B-|---|--O-OXTBO-O?O-----OOEM-O--X-XO--O--O-OO---O-OT--XO---OXEO--O-MB--O-|OOO-|--O--OOE--OX--O-?MOXBO
-O------OOOET---?B--BB---OOT-T--B-O---O-OT|OOM-O-OM-EO?-||-OO--|-T-----OX-?-------O-BBO----O---OMO--|-BO|--OO--|-BO----O-X---BOB-XOMO--O?-O----O--OOBB|--OOO----BOEOBB-OOOO-|O-OBT-OTEO--X-O----XO--O-XM
----O-OOTOBB|-XOOOB---OMO--|O|OO-----B--M||OO-O--O--M--O||-O--O|B|?OOOX-OM-----T-X-M-OOEOO-------OEO|--OBXBOOEO|--OEO--O-OO-B-O-----BO-M--XOO--XO--O--|XX-OMX-OO--XX----OMOMTMOOO|-O|XOOO--O--BBO---TOOO
-O-OO-XM|OOO|OOOO-O---?-O--|-|----MB-O--O||OOOXO-O-XOO--X|-EMB-|-|-X?-O?--E-O-B|M-B--OXMOO--O----BBO?BO-M-O--X-|---XBE-OOO-M-O-OXO--O-?--E----O-T--B-O|-O-O--BB-XO--OO-OM--O|O?B-|OO|--BOOO--OOO-EMM|---
---O---OXO?-|O----O--O-----|-|-OEO-----O-||EOX-BOOE---OOO|MMOOX|-B----O---B-TMM|OO--M--O-X-OXOE?-O---O-BO-O-X--BO-O-OXT-OE---T-OO--O-B--OBOO-E?O|B---B|--X---O-M--E-O---O-O-|-O--XM-|-O--O---OO--B-O|EOv
---OOO-O---X|OOB-O-X-TO--B-|-|O-T-E--BXXMX|M-OO---B--OBM-B--OOO|---O-?--XO-?B-O|-M---O--XOMOO-X--OO--O---OB-OO-O--O--O|X-B---|---??-O---XO--OBO-|OOE-O|?---OXOE--MB-O-B--B-O|---O--O|--EOEOBOXM--OOO|BE-
----O-XXOE--|OMOXOO-O|O--OB|-X--|XM-O---O-BXOOO-O--O-----O-M?O-|E-OX--XO-XEOO--|XOOO-B--O--X--OOX-OM----ETOX-----XOOB-|OOOOE-M--O--O-O-EO-O?BO-B|--?--|--O?--OM--OOXOM-O----|-O--O-MXOEXBB--T--?--MOX-XO
--OX----OX--X--OO--O-|XO---|EO-M|-O-O-------O-B-XO-XMM--BOOOO--XX--OOO----X-O--|O-O-OOE-OOO--O-O-OX-O-EXX|O-O-OO-OBO-OB-M-XMX--MOO-XOOOM--------|---OO|---O-OO-EO--OO--O---XBO------OOT-O---|OO--?OOOOOO
--O-OX--O-XM--E-OMTEB|OO--OXB-OO|-XOE-XOO-E-MBO-OO----OOO--O---OOEE--O--MO-BT-E|E-O-OOM--O-O-OOOO--O--T-O|--MOT---O--TXOOO---OEO-BO-TXX--MO--OO-|XOO-?B-B--OBO-?OMO-T-?--M--OOEM-O--OO|--OM-|EOO---E-O-T
-OMOOOXO-OOOOXBO--|B-X-OOOO-OBX-|?-XB--XBOM----B--B---XBOMXO-?BO-??BMXBX--O-|?BXMXO--X-BO-??XXOO?O-XO-|-O|TMO-|OBOOM-|-M--O-OOT-XOMO|----OO-B--B?OTOO-O?-B--OOO--M?O|M-O--O--BX-M?MXBO|X-O-O|BOOBO-BBXB|
-o--o----------o-o|o------------|---------oo-oo------------o-----------o---o|--o----------------o--oo-|--||---|------|--------|-----|-o-----------|--oo--ooo----o---|-----o-----------|---o-|--o-o--o--|
mo-o-o-----------E|E------------|oo------o-o-o----------o-E-E-----------o---|o-E-o---E---------E-o----|--||---|----oo|--------|-----|-------------|--------o--Eo----|--------------o--|-o--o|---Eo-----|
XXXXXXXX-------XXXXXX--X------XXXXX------XXXXXXXXX-----XXXXXX---------XXX--XXXXXXX---XX-------XXXXXXXXX--||---|----XXX--------X-----|XX------X----|--XX-XXXXXXXXXXX-|-----X--------XXXXXXXXXXXXXXX--XX-|
