--------O-O-----O--------------E-E----O--O-E-------O---OO--O--O---O-----E-------OO-O--OO-O--OO-OOOO--------O-O-O--O-O-O--OO-O-EOE-----OOOO--E---OOE-OE---E--O--E-O---EO------O---O-O---O--O-O----O---O-O
---OOO--O-OOO-O-X-OB--EO-OOXOOO?-M-OBB?OO?-BO--TO------OO-O-OO-O-B-O-OOO?-O-O-OX-O------O-EM-OO--EO--OBOO-MOOO--O-?-X-MMOO-O--BO?OOX-O-O-EM-XOO-B-X--TMO-MO-OBOT--T--T--OO-E-OX-MOOT-EOOBOO-OOOOX-OO--OM
-O--OOOO-OO--OOB-O---BM-O-M--?MOTOM---O-O---?-M|M-OMO----X?O----MOO--O-O-OBO-O---OO---MO--T-EOOO-M-EE?-OEXO------OO-----O--MX-OOO---O---EMOBXXB--O-O-|--OO?ET-M|--|-B|-OB--M??OO---|TM---MBB-B--O-OOBXO-
--------OO--OXBOOOOE-O-OE--EX---|EO-E--T--B---O|-TO-----?O-BOMOM-OOO-O----E-MOO-X-O----B-E|-B----O-XX--MX-EBO----O-MOXO--MX--XOBOX-O--MBX-EOOOOO--O--|----OX|O-|X-|-O|-MOE-----M---||-XM-O-OO----O-O-O-O
--O-OO--O-OOOOO-OOX?BOO-BX-X----|B-OXOT|O--B-X-|-|-OMOEXOOO-O?M-O--TO-?BO-X--?O---MOO-O-BX|---X-O-OO------T--MEOOM-OX--BO---O-OOOOOEOOEE-OXO-O-XXOOMOXO---O-|X-|--|OO|O--BME--BO--OB|-OO-O-OO--EOBBBOO-E
-OOO-OOO-OX-BE-MXB-O-------O--BT|-B--B||O-E-XOMBO|O--OMOO--?--O-OO-|X----BO--?--E----BTE--TOO---O--O-OO---|EO-BX-OO--EM--OOOOO-O--BMB-XBOO---E---BO-XO--O-T-BO-|-XX-O|B-E--B-MOOX-MO|BE---O-OOTBOO-OT-XM
-----O----OOOX---O-O-?-O--X--O-|T-----||--M------|E-O--O-----O-OOOO|-O-E--OB--O-B-O--O|B--|MBB--OOEO-XO---|?O--OO----M--EBOX----TEM-OO-B---OOXOE--O---B---|BO--X---EB|EOBEOOT-----OO?OTB---OO-|OOOO-|?-O
--OO-OO-OEEOEOOOOO--XOM-B-OOBO-||-O--O|X-M-M--OOT|B-O--O-BEEB?X-OO-|--?BX-B-O-O-EXO--O|-B-|OO-XOMBBOO--OOO|--T-EOM-X-OO-XO---TXO|X-OE--O?---X--XOO----O-XO|-O---B-EM-|XE-XM-|-E--O-BO-|-O-OBO-|O----|-Ov
-----O-M-TT-T-BOB---OX--O-OO-OBX|O-XMO|----OBOBE|B-MB-TMX-MX--O-O--|-OO------O-XXO-XB-|--MM--O--OO--?OM-OX|--|-X--OOO-M-O-O--|-O|---M-?--O--OBOO-O-OB--O-X|E--O--BBOOB-BO---|-XXTOOOOO|-MB-XO-|OOB-O?---
---O-----||O|EOO-OO--OO---O--OO-|??---|-OOO-EO-BM-----|--O---O-B-TB|TBBO--O--XOO--OO--BO--O-E-----O?O?---OB-M|O-OE-OO--OEO-OO|-X|--OOO-OOX-E----?OO?OOMB--BBOBEE-----O----OO|OOO|B-O-BB--OB---|O----OB-B
-OO-OMX-M||-|MO-OO-O-OBOOOOO---O|O-OEB|OE---BEO----OOX|-O--------|-|M---EOT--O-O---OO-O--EOOXM-?O---O-------O|E-OMO---OEX---MX-OBEOOO-O-E-OBE-----OOO-OO---OE-XBOE---OBO-XTB|X-O|--M-O-T--O-OO|-O-MO---E
-O-E---O-BXT|-X?X-O-OX-OO--O---O|OOXM-|-BBOE-X-OEM-MOO|-OXB----O-|O|O--OB-|EXOOO-M--XTO--MO?--E-MXM-E-EO-B-OOBX--M-OOB?X----O----X?--O--B-B-B-O-E-O-O--OBO-EMO-O-X-BOO-B?-|-XO-B|-OOX-O|BO-O--|----B---T
---X---OO-O|M---OOB-O-O-X-O-OB-T?XXMO-X--O-MOO--XOO---|OOO-B-O?OB|-?--?OO-|T-OMOB-OTO|?---?-OO?-OO-MMOMO-OXT-O---OOT-O-O-BXO-O---O--BB-OO---OO-?BX-X-O-B-B-M-O-OO--O?--O-O|OOO--|----OO|OB--OOBBOM--X-O|
-----------|--------------o-oo-|---------------------o|----------|o------o||o--o---|-|o-------o-o-oo-------|-------|-----------oo----o---o--oo-o-ooo-------o--------oo-o--|-----|------|-------------o-|
m---oEE--E-|------------E-E--oo|---------------------o|------oo-o|-------o||-E--oo-|-|--o------oo---E------|-------|E----------E-o--o-o----o-E-o-o---------o--------o--o--|-----|E-----|---------------|
XXXXXXXXXXXX------------XXXXXXXX---------------------XXX-----XXXXXXX-----XXXXXXXXXXXXXX-XX----XXXXXXXXX----|-------|X--------XXXXX-XXXXXXXXXXXXXXXXX-------X-------XXXXXX-|-----|X-----|---------XXXXX-|--
