--------------------------------------------------------------------------------------------------------------------------------------------------------------------------------------------------------
---------------------O-----------------------X-OO-O---ET-------------------T----B----M------------------MMO---------T-OO--M------------O---------O------O-O--EE--------X---?--O-----------O-B----X------
-------------------OO-------O----B---------M--E---M---X|------E----------O-|EO--------------XE-------------E--------|-----------OX-B-----------B------E------BBB---OE-------------------------B---------
---------------------?--E---T-M--X--------O---B-----O--|XO----M-O---OX-O--O|BX----------O----M----O-O-----OX--O-----|---EO-----O--X-TE--O--X--X-T-----B-O------O----B-------------TO-M----B-------------
------------------OB----X--M|------X------E--X-----O--O|-O-----O-O---OOTB--|------OB---O---O----------O-X----------?|B-MB----XO-----|X----O-----|O--------O------E--------MO---B--|-O---B---------------
-----------------BB----T----|----O----O---B-M------M--B|--O------------|---|-O--OO-----B-O----------O---------------|-?--O--O-X---O-|----O--O---|------O-O?------X-O--------------|---B----B--?---------
-------------O---------|-O--|---X-O-M----O-M-----BO-O--|?----B--OE-----|---|-------OT----X-BO------------OO----O----|---O---X-------|------?-O-T|-----------X-X---O---------------|XO---E---O-----------
-----------X-----------|----|----B---OOM----O-O-----M--|-O-O-----TB----|---|-----O--|------O-O---O--M-B--O--OO------|---X----OOX---O|X--------O||-------X---O------O--------EE----|-----B------BO------v
----------O---B-------O|----|----O-------XM-O-------OO-|O-------B|-----|---|---O----|O-------O-----O----------T---B-|--B-O-----OO---|O---------||---------E--BOO------------XT-X-E|----EBB---O---------f
------O-------------X--|----|------T-----------------E-|O------O-|-O-E-|O--|-E---OMT|--B---O---O----O----O----|-O--?|M----X---------|----E--O-O||MO------OX-----O-B-O--B----B|---M|----X------E-E------f
---------------E-E--O--|---E|---O--|---O-E----X--OO--BO|B-------OX---X-|OO-|-T-----||-O--O-B--O---M-O--------O|-TM--|O---------X----|----MM----||-------XM------X--------X--O|----|-----------X-T------f
-----B-B-O-X---?-T-----|-O-M|----OB|-X-B-?-O---BO-O----|--------------O|---|-|-----||----E----E------------EO-|-|---|-O---------OO--|----O----?||--X-O-O----------OB---------|----|------O------|X-----f
---------------OB|-O---|----|--OX--X-------------OX-X-O|--O-XO-------O-|--M|O|-----||B---M---BB-------BO---?X-|-|---|---------O-----|----------||-O-------O---------O--T-----|----|---X--O-----O|------f
--o-o--o----oo---|----o|----|----------o---o-----------|-------oo-----o|-o-|-|o-o--||---------o----o----------|-|--o|-----o----o----|--oo-o----||---o---o------------o-|-----|----|-------------|------f
m--o--EEE--------|o----|-o--|-------Eoo--oEo-----------|----E--oo-----o|-o-|-|o-EE-||---EEo--E-E--------------|-|EE-|E---E---E--E---|-o-------E||--o---o-------E-o-----|-----|-EE-|-E---E--o----|------X
XXXXXXXXXXXXXXX-XXXXXXXXXXXXXXXXXXXXXXXXXXXXX---XXXX--XXXXXXXXXXXXXXXXXXXX-XXXXXXXXXXXXXXXXXXXXXXXXX-----XXXX-|XXXXXXX-XXXX--XXXXX-XX-XXXXXXXXXXXXXXXXXXX----XXXXXXXXX-|--XXXXXXXXXXXXXXXXXX----XXXXXXXX
