--------------------------------------------------------------------------------------------------------------------------------------------------------------------------------------------------------
----------------o---B--------------o---Xo------B-M--------o--X--M---------------X--------E---M--------B-----X-o----o-B-X-----------oo---------------B-----oo--B---X-o---?--X---------?---M?-------------
------------------------B---------oE-------------o-------X----o---B------XM-B------------?----?----B----B--o--o-o---E-T-----------E-o--o-----o----E---X-------------X----o----o-----------?-o-----------
------------o-----o-----o-------E--B--M----M-----o---o-----?--B-E--o----B--B---o---------------T-o------------------X-|E------B---B--------X-----oBo-o-------------oBoX-----Bo---o----------?---oB------
----------------o--B--oXE---BEX-B----E------o------------oo-----X--o--o------E---M--X-oX--B----|oo------o-------------|B-B------M-o----------o----------------X----?o---M-o------------o--------o-------
---------------------o--B-o--X------EX-----------o?-----o--------o-------o---X---o-o----o------|o------X---o-X-o-?o---|---MB-----B-o-o--------B-------------M---To----------o--------M--o-----X-E-------
---------------o--M---o-------------B------o--o?-E---o------E--E--------M?----B-?-oo---------o-|--------B----------o-X|-----o--T-o--E-oB---o--------o-----o-----|-o-?----E----E-o---o-oX--------X-o-----
-------------------------E---ooo---------------M-B----------X--B----X----oEo-------MT--oEo----o|oE-X-o----o-----------|--------|--B-M--------B------o-B-------oo|-o------B---E?--o------M--------------v
-----------------E-------B-X---o-X-----M--------o------M------o-M----o----?-------o-|---B------|-X--o-B----E----B-----|M-o-----|X-----------------------?---o---|E------o----B-----o--o---B------oT----f
----------T-B----M-------oo----o-------E--o--o--------X-----o----E---o-B----M-----o-|-B--------|o-E--------M------o-o-?o-E-----|-o-o-------------X-----o----M--B|X---E--------o-Mo-------X-T--oM--|----f
----------|--------------E----Xo-------B--M-X--?-----------------X-B-------------oo-|--o----o--|-oX---o-----B------------B----o|-----X----M--BX-o----------E-X--|----?---E---oo---E--------|----o-|----f
-------XMo|o-------------X---M--B-----B-----o-------X-----E-B--B------M--------?o---|-------X--|oo--o-E---B----o--------o----o-|------o-----------oB---X--oM----|---M----X--------X--M----X|------|----f
----------|---o------------B---------------o--oo--------M-MX------M----------o-o----|--M---M--o|----M-XM--o---X--X---o--o------|------------o---oB-o--o-X-B-o--o|-X---BB----------------B--|----B-|----f
----------|------------o-o--o--oo-------------------o----o---------oo---o-----------|--oo--o---|oo-o-----------o--o----o-------|-o--o--o------------------------|------o-------o-----------|----o-|----f
m------o-o|--------o-----Eo-Eo-----o------E------E--E------oEE--------------o----E--|o-E-o-----|--oE-o-----E--E--EE--E-o-E-----|--o-----o-o-----Eoo----------oo-|----E-----o----Eo-------o-|----E-|----X
XXX-XXXX-XXXXX--XXXX-XXXXXXXXXXXX-XXXXX-X-XX-X--XXXXXX-X-XXXXX-X---XX--XXXXXXXXXXXXXXXXXXX-XXXXXXXXX-X--X-XXXXXXXXXXXXXXXXX-X--X-XX-XXXXXXXX----XXX---XXXXXX-XXXXXXXXXXXX-XXXX-XXXXX---XXXXXXXXXX-XX-XXX
