--------------------------------------------------------------------------------------------------------------------------------------------------------------------------------------------------------
-----------------X-----O--------O---------O------?-----?----O---------OE-----E-M-O---------X----O---------OE---XO-----------------O-X-----------OBX--X---O----O-----O-----------------------------O-----
-----------------O-B---------?----O--------?O---------------?O---?-----XO----X-------B---------O----------EX----E--B-MO------X---------X---M----------O-O------O--------------BXO------X--BO---O--B-----
----------------------B--------M----O-----E--------O---------EB------?----XE---O------X--------------T-M--X-----?--------------------------E-O--X-E-B-X----O-O-------O-------------OXO---------EB-------
---------------O---------O-------X-M------X-----E------------B--O-------O--X----------------------B--|----------------OO---X--------X---O-EM---T--?B---------E--XXO?------------------O--BO----M--E-----
--------------B-----------E--B-O--O----------M-OX-------------O--X------OO--OM----------B---O----O-?-|O--E--------O---O-O-O------O-O---O--?----|--------OB-O-X------O-O-----O--BO--OOM----T---O---B-----
--------------------O-----XBB--O----X---TOO-----OO-----T---O-O-------M-O-X--M--OOM----O--O-----E-----|-O-B----EB----M------------O?----M-X-----|---O---?X-------O---OB---O----------OOOO?-|--O----------
------------OT--E---O-O--------B-B-----X|------X-----OO|O--OOO---OM-----O--O----------O---E----XM----|----O-?-TO--O------O----O---O-----O--X-EO|X-BO-O--E----OO--X-M-----X---B--------OE-O|-O----------v
-----------TB|--ME---B------E----------O|-------O----M-|------X----T-OO---------X-O-------M-------X--|----O---|---------O-----X----B-XOE-----BM|--------T--XO---B---E---O-E-O----------B--|-----T------f
-----------|-|O--B-O----OOO-X-----------|--B---O------M|--OX?---B--|O--E-T----O---O-X--------E---O---|--------|--EX----M-----EO--------B-------|---OBB--|---T-O-----X-----X-----O---O--T--|-----|------f
----------X|-|E----X-----O-------O------|---O----O-----|-----------|---B-|-------------M-----X-OO----|----B---|-XBB---O-----OBO----O---OO--M-E-|--------|-E-|-----------------EB------O|?-|-O---|------f
--------T--|-|B--------------XO---------|------X-------|-----------|-----|OO----------O--E----?----M-|-----E--|--O-----------O-------B------O?-|--B----O|TX-|------------B--O-M--------|--|-E---|OX----f
--O---OO|--|-|-X-----O-----B---O--------|M--------X----|T-BM---?---|--OO-|-M-------------BMO-----O---|-----M-O|-O--O-OO--------O--O------------|-X-O----||-O|-----X-OO-------O-B-O-----|--|OB---|B-----f
--o--o--|--|-|---o-o------------------o-|---o----------||----------|-----|-o---o-oo---o--------------|--------|-o------oo----------------------|----ooo-||o-|o-----------o-o-----------|o-|-----|------f
m-o-----|--|-|E--E-----oo---------------|-o--------o---||----------|--E--|-----E----E--------------E-|--------|---oE---o----o-------------E----|--Eoo-o-||-o|o-----E---------oo---o----|--|-o---|------X
XXXXXXXXX-XXXXXXXXXXXXXXXXXXXX----XXXXXXXXXXXXX-X--X---|XXXXXXX----XXXXXXX-XXXXXXXXXXXX----X-------X-X--XXXXXXXXXXXXXXXXXXXXXX--X---XX----XXXXXXXXXXXXXXXXXXXX-----XXXXXXXXXXXXXXXXXXXXXXXXXXXXXX-----XX
