--------------------------------------------------------------------------------------------------------------------------------------------------------------------------------------------------------
-----------------------------B--------------------B----X---E---------X?---O------BO---O-----------O------O-----B---------B-E------OMM----OE-----------------X-----------------O----B-----M-----O--------
--------------OO-----X---O-O------OB------------O----------?-O----O----B------O--------------T-OX---B----O-BO--------BB----B------O--O-O--X----------O-O------------------B-------O----O----------O-----
--------------O---B-----------O-----------O----OX-----------O-----O-O----------------O-------|E--OEOO--E------O----------E------------------------O-------M----------O--B-----M---B---O-----M-O-M-------
--------------------------------X----O----B----O--MM---OOO--------B--------O--O-----B---X--?X|B---M----X----O-O------E---BO---X-EO-E--------O------X--O--O---OOO------O-O--M----B------O-----TM--E------
-----------XE-O--------B--M-T-O-----X-O-X-O--M------?--------------O--------?---M-----?------|---T-----O----E--O---B-X----------BM-B----------OOO--------------O-------O-------M----------E--|---TT-----
------------B------O-------O|---O----------B-----M-----O----X----------------------O-E-O---O-|---|----------MO------T---O-----OX---------------OX----------------EO--O---O--------O-------M--|E-?||-----
---------------E----------O-|--------------O-O--OO----OB---O----O----E-----O-----O---B-------|O--|----------O-------|-----------------X------------EXO-----O----XM---------XO----O-?O--------BB--||----v
----------O?---X------------|O-?---------------M--O---M------O---O---MX-----------M-----XO---|---X------EO-O----E-OE|--O-----E---O-O-----?--OBM----X---O---?M---------OOM--O--------O-----E---O--||----f
-------M-O--OEXM---------O--|-----------X----B---------O----------------XX-O---------OX--O---|----OE---OXEB-----M-XX|--------?--X-EO---O----E-----------BO---M----B--BOO-T-------------M--TOO----|B----f
-------O-----X-O--OO-------OB------E---X-----------BO--M----X---O-O------------O-------OO---O|-----X-OXO-B-O-O------M----------O--B---O-T---M----O---E------O--------O---|-B-E-------?----|-B-X--|-----f
----------E------O------M-----B-MO-?-T---O----X?----------------O----OO--E----O--------------|---T-----------O--E----O-----O---X---O--O-|-??--OX-----M----O-O----O-----T-|---M--------T---|-----O|-----f
----M---T-XO--BB--O---O--O-----------|-O-X---X----OO-----------X----M----M---B---O---OO-----B|---|---O------O--O??------O----------M----|-O---------------X-----X------|-|--O-O----O-O|XB-|-O----|-----f
------o-|--o-------------------------|-oo------------------o------o------------------------o-|---|----o------------o----------o-------o-|--o----o----------o-----------|-|--o---------|---|------|-----f
m--oE---|-------o-------------o-oo---|-oo--o---------E-----E-oo--ooooE---o--------E-o---E--E-|---|----o------------o-E---------o-o-EoEE-|----o-E--------oE------E--E-Eo|-|------------|---|Eo----|------
XXXXXXX-XXXXXXXXXXXX---XXX----XXXXX-XXXXX--XXX-------X-----XXXXXXXXXXXX-XXXXX----XXXX-X-XXXXXXXX-|-XXXXXXXXXX-----XXXXXXX-----XXXXXXXXXXXXXXXXXXX-------XXXXXXXXXX-XXXXXXXXXXX----XXXXXXX-|XX----|XXXXXX
