--------------------------------------------------------------------------------------------------------------------------------------------------------------------------------------------------------
----------------O-OO---------------------------X-------------XM---B--------E-------B-M-M-OO---------------B----------O--X-B-------OM---O--M-------OXB-M------O-O---------------M---------O--------------
-----------------EO-----------OT---OXO-E---------O--OX----E------O-----B---B---T---------OT------M--------------E-O----O----X----TX-T---O----?-------------------O------------O-O--X----------M---M-----
--------------X-BX-----------X-|-------X----------OO--E--ETB----------O--O-----|-----O----|--B---O----?O------B-X--------------O-|--MM-X?-OB-----MTOE--O------------XO-------OBOB--O-----B--------------
--------------O-----------O-O--|------O-O--O----B-B---B--M|----X--ME-X------E-E|----E--BO-|-OO--------------OO---E--OO--------X--|----------------|-B-BOMO----B---B--M----------O------B-------?--------
---------------------M----OX--X|----O-O--O--------O-------|-O--O---M------O-?OB|--OOT--O--|----------X-----------?---------B-B-O-|O---BB-O-------O|----O-------O-------X-------------------O-O----------
------------B--B---X-O-------B-|-OO--M-------T-------O--O-B-T----E--X----B----OXO---|---O-|-E-O-------OX-------BM-O-O-X-----M----|-O------M-O-----|----------OO-O--------M-----------O?---B-EX----------
---------O--O---------O--O-EM--|---O-O-------|--O-----X----T|----X----------O-------|--O-M|OBB-E--O---M---M-------M--O---------B-|---B------------M-M-OO--BXOE-BB---O-M-----E----E-----O----T----------v
--------X--O-------O-E-----?--O|M---------XO-|----O-X--E-MO||--E------E-------O---?-|-----|--O-X------------X----------T------E--|--------------B---O---O-OOBB----O---------M---X?-OO-------|----------f
------B----E---E-----M-----O---|--O-----M----|--------OX-XX||--M------B----------B-B|-----|O----XETX-O--------O-----O--|X-----B--|X-O--E--------O------B?-O---------O-O----O------O-OMOB---?|---M------f
-----------T---M-O--E---------X|-------------|-O-----------||-------BX----O--O------|-----|------B|---O-------M--------|------O--|---O-M--O-O--------O-O---O---------------------------O-O--|-OM-------f
-----------|-O--E--?X-------X--|-----O---B--B|-------------||-E---O-----M-O----O----|---MO|--O--O-|----O---X-----------|-E----OE-|---O-----XB---M---O-------XO-------O---T---?O-EO--E-O-O--O|--O-B-----f
----T------|----X-----O--------|--------O---B|-------------|B-X-X-?-------------B---|---O-|--X----|----O-----------OO--|-M--B--M-|---O------------OO----O--------X-BOO--O|------XO--B-?-----|----OB----f
----|o-o-o-|--o----------------|-------------|-----o------o|-------o----o------o----|-o---|-------|-------o------------|---------|----o---------o-o--------o----------o-o|------------------|----------f
mE-E|-o----|o------------------|---------o---|-----o-oEEE-o|---E--Eo-----oE-o--o-E-o|---o-|--E----|---------o----------|---------|-E---o---o-E--o-----oo----------E------|-----o-----E------|-----------
XXXXXXXXXXX|XXX-----XXX--XXX---|-----XXXXXXXX|---XXXXXXXXXXXXXXXXXXXXXX-XXXXXXXXXXXXXXXXXXXXXXXXXXXXXXXXXXXXX----XXXXXXX-----X---|XXXXXX---XXXXXXXXX--XXXXXXX----XXXXXXXX|-----XXXX-XX-----XXXXXXXXXXXXX
