--O---O---O--OO-------OEO----------O--OO--------O-----O--OOO---E---O----O--O--O------E------O-EO---OO-OO------E----O--O--O-OO-O-E--O-----E------O--EO-E--OOO-O-OOO---O-O-------O--O------OOOO--O--OE---O
-O----O----O---E?OO----M--X--EX?OO-----O-O-OOOO-O-O-M?O-OOOO-O-XO-----XOB-O--O-O--O--BE-OO--OTXMOOO?--OTOEEM-BTO-MO-O--OO-OX---XT--X-OOO-X---O-OBO-MO-M-O-OOOO--O--O-O-M-M--E-OOB---O---EO-E---OOOMXM-OO
-----O---------XOOTB--OO----BB-O--?O---O-OBOEO--OEOOO-O-?O--MBO--OOO-M-E--OX-OE--O--XOBEOEE--|O--O----O|O?XOO-|OOOB-OOO---B--T-O|X--XOO---E-O-O-OOX-O?-XO-O-OOT-BOO-OOO----OMO-X---XOBXOB-OBBOO--O-O-E-M
-----------OOXBO-O|OO--OOEOBO-O--O-O-O-MOOOOXOBO-XOOO-O-OO---O--TEBEO-O?----OBXX?MOBO-OX-TBXO|--?----T-|-----E|--OOXOB-B-B-E-|--|-OO-X-?X-XOM--M-X--M-O--B-O--|--EXOOOO--OO---O-O----OXM---O-MO---O-OT--
---O-O------O----O|OM----?-----O--OO--?OX------OO-O?O----X-O--T-|X-XO-O-BOOO--OO--M--B-OO|O-OTEB----X|O?---OOX|MO-OO------OB-|XX|-O---E--O-X-XOO-O-T-O--O---OO|O-XOOOBOBXOO-O?--XBO-O--OOO-BO--OO-OO-|TO
-O----O---O-O--O-O|-OO-MMOE--O-O---O?M----BO--OX----MOO--O--?-XO|--O--X----OT-OE---EXOO-X|--O|XOO-O--|XO-B--T-TOOO----BBO----|OO|OOBO-X--M----O-X--|O----OTMB-XO-OO---OO-O--B-OX--O--O--EO--O-OB-M-M-||X
-----O----E---X-X-|OOOBO--X-X--O-O----O--X---O?-M---?--O-OOTOBO-X--OB--?--MO|-X?MOOTO---O|---|OO-OOXO|-O---O|-|-?OO--?-X-TOO-|--|--OE-O--E---OOO--X|-OOE-E|OOO-OO-------O-XEO-BOO--MOMB-M-T--OTO----E||O
-O--OO--OOBBOM----XMO--OOE-M--X-B-XB--O-T-OO----OO-X-O---O-|-O---T-OOM---BO-|--OOO-|-EOO-|--O|O--O-O-|-XOOXX|-|O-OO-OOO-XMB--|--BOXOMM---M-BO-OXOO-|O-EXBB|O---XOBEB-M-----X---------OOO-O|OOB|OO---MX|v
----OOOO----M-O-OXO-BOO-BMOOOOOOO---MOOO|OM-E?O-OOMO-B--?-X|O-B-O|O---X-XO-O|MO-OMO|XMT-OM---X-O-OM--BBOBB-O|-|OE--OOOE----BO|B-O---O-MOX--OO-BO-O-|--MO-BBO-X--OOBOXO-EEOO-E-O--OB------X|MX-|OO-BOO-|O
-O--OO-O-O---OMO-O-OOB----B--O--OO-O---O|M-OB---O-O-M--XO--|O-O--|---OOXO-OO|--TOOM|--|TO--B-O-M-E-OB-M---OOM-|-BXOBO-X--OOOB|-OEO--O-O-O-O--XO--ME|B----O--O-XE-O----OXB---?EO---O-OMB-O-|--OXO--O---|X
--O----OO-O-E-OT--O?O------ET--OO--BEO-E|OOT-O-T--OO--OO-O-X--O-TB----EOO-M-|-O|TOO|OE||-TT--OM--MOO--O--O--OO|O-O--O-O-O-O-O|OOMOMO---OO---MO-O--X|----O-O--O-X----O-OO-ETXOXEOO-XO-OOB--|-----TBO--B|-
----O?-O-OX-B-O|OTO--O-OO--X|O-O--OOB--B|-M|O-B|T--XOOOO--BOO---|-M?M-X-OB-E|--||OO|OM?|-||E-----O??-X-O--?-O-|BO---OX-TO--O-|----O----------O-OM-O?OT-MOT--OO--O-BXT-EE-X|-O-X-BOO-OOOOO-|--O-E|--OEO?O
--OX--O--M-O-O-|B|OOOO-O-TOO|B----X-OBX-|OO|BX-||--O-BO-OO-OBM--|O-OO--O-O-B|OXX|B-|--OXO||X---M--O--O-B--OMO-MOOOBOO-M|-OO-OX-BOO-??-XTXOOBOOOO-OO-O|O-X|---?--OO--|OXXBB|O--O--T-O?OM-TB|X-BXM|MM-B-O-
--o---o--------|-|-------|--|o----------|--|---||---------------|--o--------|---|--|---oo||---------o----------o---o-o-|--------------o|-------------|---|-------o--|-o-o-|------|---o--|-|-o---|--o----
m---o-o--------|-|-------|-E|-----------|--|---||---------------|---o-------|---|--|-----||o--------o---------o------oo|---------------|E---E-o------|---|------E--o|-----|------|-E-o-o|o|-----|-o-----
XXXXXXXX--X----|-|-------|XXXXXXXXX----XX--|---||-------------X-|--XX--XXX--|---|--|---XXXXXX-------XXXX------XXX-XX-XX|-------------XXXXXXXXXX------|X--|------XXXXXXXXX-|X-----XXXXXXXXX|-XXXXXXXX---------
