--------------------------------------------------------------------------------------------------------------------------------------------------------------------------------------------------------
--------------------M----?----T------X----E----------?-M------o--------X--------------B-------oE-----------B-B-?M---o--o--------------B----oo-------------------o----B-----MM---X--------------o--------
----------------------------E-|Xo-o---o---Mo-X-E----o-E-------o---------Eo-o----------------o--?-------o-----oE-------------o---o------B-Bo----------o--------MB----B----------------o-o----------------
----------------------------BB|--M----------o-BX-?----X----B--E--o---XX-BB---------o---oX-------o----o--------Mo---B--XT-----------------o--o---------o-----------o------------?-o-B---B---------o------
----------B-----------X---?---|---oo-------o-------Xo--o-----BX----------------o-o-E----oE-Mo----o-----o-------o------o|--o-Eo--o-X--o------------------o--o-----o-B------?--X---M--------oo-Bo-o-E-----
----------------------o-------|o---XB----o---------o---o-X--------M-o--------E-----B-E-E-B--E----BEo---oX-o----oo------|-oB-M-M------X-----M-M--------------B--o--------T-----T--o------------oTo-B-----
------------------------------|-X---------BooMo-----B--X------o-----------o--T-M--o--BBB----M-MB--X---------M--M------?|-o--o--o?B-------T----Bo----o--------------o--E-|--Bo-|---o-----B---o--|--------
----------B-o-o----o---o------|--------------o-?--o---oo-o-o-o--o---o---o----|-----o--o-------------oX-----------X-----|---B---o----B-o--|o-------o---E------------o--X-|X-oB-|o----M------o-E-|--o----v
---------------oo-o-o---B-o---|--o--o-------------X---Bo--o-------X----------|--o--------o------B-------X--T-----------|---o----------o-o|o-o----oB--BM--?-----------o--|o----|----oo--X-Xo-oX-|B------f
---------E------EXo-----------|Mo------o-o------X--------X-------------------|X-E--o-?o-o-------o--------o-|-E--B------|-X---?o?---------|B----Eo------M------M-----B--E|-----|-o------o--o----|-------f
---------B------X---E--X---X--|------------o-o-oo------X--------o----E-XXE-T-|o-B----------------o---------|oT-----M---|------X----Bo----|oo--oM---o-------oo--o-----o-M|-----|----------------|o------f
-------o----B----o-oT---------|-o--X------------------------------X--Mo--Bo|-|---o--o-?---o-------------X--|-|--------B|---B-o----B--o---|------o---o--------------E---o|-----|--o---oM-o-T----|-------f
-----o-B------------|---------|-M----------o-------o-o-------------T-o-----|-X---X--M-----X?----B--o------M|-|--o------|----o---oo---o---|o--o---X--X-----M-To-----Bo---|--?--|o-----oo---|--B-|-------f
---------o----------|------ooo|-------o-------oo--------o-o-------o|-------|-o---o---o-o---------------o---|-|---------|-----o-----------|------------------|----o------|-----|--o--------|----|-------f
m---o-o-EE-o------E-|E--------|----------Eo---o-------o------------|-------|-Eo---o----------E-E-o---------|E|----o----|oo---o-----E-----|------Eo--o-E-----|----oo---o-|----E|o----------|---o|-------X
XXXXXXXXXX-X------XX|XX----XXXX-----XXXXXXXXXXXXXXXXXXXXXXXX---XXXXX----XXXXXXXXXXXXXXXXXXXXXXXXXXXX-XXX---XX|---XXXXXXXXXXXXXX---XXXXXX-|---XXXXXXXXXXXX-X-|XXXXXXXXXXXX----XXXXXX--XXX--|--XXXXXXXXXXX
