--------------------------------------------------------------------------------------------------------------------------------------------------------------------------------------------------------
------------------------X-------------------o----------o-o----X---------BX--oM--o------------o-------------B-------o----------E-------o-oo-------o--------------B-------------o------o------------------
----------------------M----o-----o------o------X----E----B---oo-oB----oo----o---X-o-------X-o-oXX-BT--------oE--------T----BX-Mo---o-o----o----o--M-o--o----o-o------MM----o-----o-------------o--------
------------------------oME------o-----o---B----E-o-Xo----o-------X--------E-------o----X----o----o|---o-----B-------E|--------E-o---------o-------o-------------o-------o--------B----o------oB?-------
-----------------o-oB-----?BM---X-o----o------o-?---oo---o-------o-----o---?-o----------o----E-----|--E----M----X---oB|---T-o--BT------------?--------o---o------------?-----oB-oM----oo-B--o--o-MM-----
----------------------o----o--------X--o-o---B-------E------oE------------M-----o-o--------T-B-----|E-B----o----o-----|---|----E|----X---o-o--------------o------Eo------------X-------o-----?-o--------
---------------E?-o----o---o----------oE---o--o------Xo--X---B-----M-Bo--Boo--M-----o-X-o--|-----X-|B--o--B---X--B--X-|---|----B|-T----M--------Xo-Eo---o--------M---o---?--o---X-------E--M---M-o------
---------------X--------MEo----T--o---XMo---T--o-oo-----------------Xo-----M-o-----o-----o-|--Eo---|---BE-------o-----|--o|-M---|o|------M----X-oo-M---------?-o--o-o----oB-o-----oT----T--------------v
-------------------o-----X--M-?|o---o-----o-|M---oB------X---o-oo----o---o-------E---------|--T--o-|----XX-B----------|-ooB--B-o|M|------------o-o------o----------o--o--o-o-----o-|--o-|E--o-o--------f
--------------o-o------------o-|o--T-o-oXooo|o-------------o-------M-o---o---o-X-?-o--?----|-o|---oX-oE---o----X------|---------|-|-----X--B--E--o---------M------T----T-M-X--o--o-|----|B--o----o-----f
-----------BEBB-o------XX------|---|--o-----|M------o-----------o-o------------------o---o-|--|--o----X-----o-----M--o|B-B------|o|B-------oM-B-----------o-E--oX-|-o--|--o---o-o--|M---X-X--o---------f
---ooo------B----------------M-|---|---o----|---o------Mo-o--B--o--o--o-E-----?------------|--|---oo-----o--X-----ooo-|------o--Mo|-------------------XooB--X-B--X|oo--|--o------?T|o-----------oo-----f
--o----BX-----o--o-------------|---|-o-o-o--|--oM----o---X-M--------o---X--X--o------------|--|---------o------o-----B?------M-o--|--B--------o--o---------o-o---o|X---|-------oX-||--B----------------f
-------o---o-------------------|---|--------|-----------o---------o-o------o------o---o-ooo|--|--------o-------o-----oo-----o-----|-------------------------------|----|-----o----||--------------o----f
m---o-o----o------o--------E---|---|-----EE-|-----------E-----o------E----------o----------|--|--o---o--E------------o-o--EE--o-o-|---E------o--E-----o-----o--o--|----|oE---o-o-o||--E-----------o----X
XX--XXXXX--XXXXXXXX-X----XXXX--XXXXXXXXXXXXXXX-XX---XXXXX---XXX---XXXXXX--XXX---X-XXXXX-XXXXX-XXXXXXXXXXX--XXXXXXXXXXXXXXXXXXXXXXXXXX-XXXXX-XXXXXXXXXXXXX--XXXXX-XX----|XXXXXXXXXXXXXXX-----X-----XXXXXX
