--------------------------------------------------------------------------------------------------------------------------------------------------------------------------------------------------------
-------------o-----o-o---------------oE-------o-E------T----------B------------M---o---o--------?-o-------------o---E-----o---------o-------E-----------------M-M-o-o-------X---B--M-----------M--------
-----------------M------T----o----E---B------E--B------|---o----o---B-oX----o---?o---Xo--B----------o-----B-------o-M------------o-oo-------B------------B----------------------o-----------------------
----------------o-------|o------X-B---o-E-XXoBT-----o-o|-------------o------M-o-------B-------?--oo------o------------------------Xo-o----o---B-----------------o---------------oB-EB-----o-o-----------
-------------B--------o-|---X--------E--B-----|--------|-----XT------o---B--------o-o--TM------------T-----------------o---E-------o---ooB--------o?E------Eo----o--------o------o-B-ooE-----Mo-XB------
----------------B-------|----E-------X---o----|----T--o|o-----|---o------oo-o---?E--o--|--E--M----X--|-----------E---o---o-M-----------o-----o-oo-o-XBo----B-----B----B----------o-o---M----M-X---------
------------B-E---o-----|----B---------o------|----|---|EM----T-o-o-----oo--XM-o-B-oo-X|--M-o----X---|---E-------X-----o-o---oo-----E--o-----o---------E-?B------------------o-------o----X-o--M--------
----------B--X?-oo------|----o--------B-------|--E-|---BB-----|--Mo-----o----o---------|X------------|o--B-o--oB-o------Mo--o-----o-M-o--B--X?o----M-o-XX----E-------E---o--------E--T--E--------------v
---------B------------oo|------------o--------|--XX|-E---o-MoX|----o--?B-o-----o-------?---X--------T|B----MoE-oo-------------BXo--X-------------------------X-------T-o---M------X--|--BX-oo---T-o----f
----o-------------o-----|-------------o----o--|----|-B-ooM----|---E------X-o-o--o?--------E---------||-------B------------X-------------B-----------o---EBo----X--E--|------X---o----|-X-----oB-|------f
--------o--X----E-------B----o------M------?o-|----|o--oo-----X--XB---------o-------------?--B------||-----------B----------o?--------------E-o---------X---------Xoo|-----o---o---o-|B---------|------f
------o---------X-----------o------E---EB-----|o---|------B----M--oX--M----------oE-BE--------o--o-o||----oT------------MB------T--------X--M--BT------?--M---------B|o------oo------|----------|------f
------o----------------o-B--o--o---X---?------|--ooX------------o-----------------X-oM--------------||o---o|----X------o--------|--o-----o--oB--|--?-X---------------|------o----T--B|o---------|-T----f
---o-----o-----------oo------o-----oo-----o---|-----o---------------------o------o------o--o-------o||-----|---oo-o-oo-------o--|---o-o---------|--------o----------o|-----------|o--|-------o--|-|----f
m-o-----o-o-o-----E--------------E--------o-oo|-------------------------------------o-----o-o----oEE||E--o-|E-------------E-----|-----E------o--|-------o---------o-o|--------o--|---|---E-----E|-|----X
XXXXXX-XXXXXXXXXXXX-XXXXX--XXX-----XXX----X-XXXXXX-XX---XX---XXX-------XXXXXX---XXXXX-X-XXXXXXXXXXXXX|X--XXXXXXXXXXXXXX---XXXXXXXXXXX-XXXXXXXX--|------XXXX---XXXXXXXX----XXX-XXXXX-XXX-XX-XXXXXX-XXXXXX
