--------------------------------------------------------------------------------------------------------------------------------------------------------------------------------------------------------
--------------o-----Mo-BBE----o-E------o---o-X--M-----o-----------o--B----o?X----------o----------Xo--B-----X-o----B-----B-----M--------------------B------o--B---------?-----o------?---M?-------------
-----------------o--X----X------X-----------o---------o-o---------o--------------o---o-MB----o-----X-o--B-----o-o------oB--------------o-----o--------o--------------o-------E------E-----?-o-----------
----------o---E-------M------o----B--------------------o--E-----?oo-------E-o---o-----------?-o-----o----oM-------BE-oX---o---B---o-------------------------o------oX-X------M---o--B---X---?---oB------
--------o-----B---------o--Boo-----X------X--XoB-o-o------B--------B--?---M-BB-X--oo--o-----o-----------o----------X-------------o-----------o---o-------M--E-X--o-?----MEo-o--o------oo--------o-------
-----------------o----------------------o---------X----?-B------o------B------E-X-B-o-?-E------B-------X-------o-?-------B-----X----oo-----M--B-M-----oo----X---T----B---X-o---------M--------X-E-------
-------------o----------o-o---oo---oo----------------o-o----o-----B-E---------X---------?-----Eo-X-X----Bo-M--------T-----o-------o---oB------------o----o------|---------------o-B----X--------X-o-----
------X----o--o----o-oo------o---------------M--------B----o-oX-----BX------------ooo----oooE-?-M-------------------|-X----------o-----------B--E---o---------oo|-X---------o----o---------------------v
-----------------T-?-M------?--Xo----o-------o-----oXE---o---o---o-X--o---o----?----T-------T----o----B--T-o-o--B---|o--o-----------------------Bo-o---o?o--o---|-------o---X-o----o------B------oT----f
----B------------|------o--o-o-----M---------o-------M-Bo--oo-------------E----o--X-|o---o--|------------|oX-------B|X-o--o------------------------------o-----B|---MX---o----B-Mo------oX-T--oM--|----f
--------M-X------|-----Bo---o------------E---------E--------------?-o--B--?---------|------o|---X-o---o--|--Bo----?-?-------T-oB--o--X----M--BX---oo--o--o-E-X--|---------------------B-o--|----o-|----f
---X------B----o-B--o-------E-M----o-E---B--o----o-Xo-Eo-----o----oBo---o----------o|---B?--|o----M---E--|-o-T-o---oo-o-----|o--E---E-o----------o-------T-M----|--------E-----------M--o-X|------|----f
--------------X?M-----------B--------T----B--------o--T------oo--------o-X-o----?o--|--oo--M|T-o------XM-|---|X--X--o---X-B-|---B---X-------o------X----X|-----o|-B---BB-M--o---------o----|----B-|----f
-------------------o-ooo-------------|-------------o-o|--o-----------o--------------|-------||-o--o------|---|-o----o--o-o--|---o-o----o-----------------|--o---|------o-------------------|----o-|----f
m------------o-o----E------E-Eo-E----|-------o----o---|------Eo--o----------E--E--Eo|-------||---o-------|-o-|E--E----E-----|----------------------------|---oo-|---o----o------Eo-------o-|----E-|----X
XX-X-X-X---XXXXXXX-XXXXXX----XXXXXXXX|----XXXX----XXXX|-XX--XXXXXX-XXXXX-XXXXX-X--XXXX-X----|XXXXXXXX---X|XXXXXXXXXXX-XXXX--|--XXXXX-XXXXX-X----XXXX-XXXXXXXXXXXXXXXXXXXXXX--X--XXXX--XXXXXXXXXXX-X-XXXX
