--------------------------------------------------------------------------------------------------------------------------------------------------------------------------------------------------------
------------------------------E---------------o-?X---------o---------o-----B----------?----------B--------------------oX-------M----o------?--------------o----o--X-----?------------?---M?-------------
------------------X-B---------B-----X------------------o-------------------oM----------o--T------o-B-----X----o------M--------------o--o----------o---oX-------------o-------Eo-----E-----?-------------
--------------------o--o--------B--To----o----TB-------o----o-----E--o-----ooX---EE--o---o|----------------o--X-------oE------B-o---------------------------o------oX--------M---o--B---X-------oB------
-----------------E-o---o---E-E---o-?X--------o|------------------oM-o------------X?B------|--------------o--B------o---B-B-------o------------B-------------E----o-?----ME--o--o------oo--------o-------
----------------??---oo----B-XB-------o------T|----B----B---------------------E?----B--oT-|--E-------------------oo---E---MB---XB----o-----o----------o-----X-o-T----B---X-o---------M-------oX-E-------
------------------------------------o-------o||oo?E----B----o---oX---o----X-EoX-o-------|-|--B--Bo------?-ooo---X----EX-----o-------E--B---E--E---o-------oB--X-|-o-----------E-o------X--------X-o-----
--------------o-----o----------o---o---------||---B--------B-------o-?------X----B------|-|-B--------B-----o---------T-----------o--M------M--M--B--oo-------E--|-o---o-----o-?--o---------------------v
------------Mo---o-----------------T---------||--------------Mo---------------------o---|-|-------B-T--------o-----E-|-M-o--------M-----X---o------o----?---oME-|-------o-o-X------o------B------oT----f
--------o------oo-------T--------o-|------oT-?|-----E--X--X---o-----------o-----o------o|-|-----Bo--|o--X---------oB-|Eo-E------------T----M------------------M-|---MX---o----o-Mo------oX-T-oo---|----f
---------X-o------B---o-|------o---|-------|--|----oM---T-------E------B-BX-------------X-|---------|------E---------|B--B----oB-----X|-o-M-----o--o--o----o-oo-|---------o---o---E---B-o--|B---o-|----f
-------oo---------------|o-----B---|---B---|X-|-o-o--o-oM---Xo--B-------o-------X---Bo---?|-E---E---|--X--XXEoX------|--o----o--------|-------BT--X-------o-----|--------E--------X--M--o-X|------|----f
---M--T---T---M---------|-o-----o-o|o-M----|--|-M----o-----------X-o-o------------o-o----o|oX---XB--|-BoXX--M--------X--o-------------|--------|o--X-o-oX-B-----|-X----B-M--o---------o----|----B-|----f
--o---|---|-------------|-o--------|-------|--|----------oo------------o------------------|---------|----------o--o----o------------o-|oo------|--o--o------o---|------o-------------------|----o-|----f
m-E---|---|--E-o--------|--o---E---|-o---o-|-o|--oE-o------E---o------o-----o--oE---o-o---|o-E------|----E--------E----o-E------------|--------|E---oo-E---E-o--|---o-o--oo-----Eo-------o-|----E-|----X
XXXX-XXXXXXXXXXXX-------|-XXXXXX-XX|XX-XXXXXXXXXXXXXX----X-XXX-XX--XXXXXXXXXXX-XXXXXX-XXXXXXXXX----X|---XXXXXXXXXXXXXXXXXXX-X--X-X-XXXXXXX-XXXXXXXXXXXXXXXXXXXXXXXXXXXXXXXX--X--XXXX--XXXXXXX-XXX-X-XXXX
