--------------------------------------------------------------------------------------------------------------------------------------------------------------------------------------------------------
------------------oo--?--------o-----o---X-------o-?o-o--o--------------B---X--------o---o-----o------------X-X---oo--oX-------M----o------?-------o------o---B-X-X------------------?---M?-------------
---------------------EM-B---B-----------E----B-----o------X-EX------o---o-----M----o------o--------oBo--B--o----o----o--------------o--o-----o-----------------------o-------Eo-----------?-o-----------
-----------o---------B-o----------------?-oo-----o----------B----B--E--o---T--o----E--------------X---T---M-----------oE--X---o------------------o??--------o---o--oX--------M---o----E-X---?---oB------
--------------E---------------------?E-o-------------B--E-------M--oB------|--oX---T-E--T--o---E--o-o-|-o--------------Boo----X--o-----------o--------------E-X--o-?---oMEo----o------Bo--------o-------
------------o-B--------X---o-----T---X----oo-Mo---------X------Eo------ooo-|--o--o-|-M--|-E-o--B-Mo---|X---o-X-o-?---EE-o---M--X-----o-----o--B-------------X---o----B---X-oB--------M-------oX-E-------
-----------o-E-------o-ooo-------|--o-o-X--E---o--X-----o--o---T---o-Xo--Xo|-o-----|--Mo|-B-----------|-B---------oo-BX---o---------E-oB---E--------------oB------o-----o-----E-o------X--------X-o-----
--------B----X-------o---------?-|o----X---M----o------o--o---o|o----------B---o--X|----M-------------|---------------------T----o--M------M-B------o---------oo--o---o-o-----?--o--o------------------v
--------------o----T-?-X-------o-|---o---o----oBB-----M-----B-o|--oo--ooMoo---XB---|------------BM----M----E----B------M--o-|-----------X----------M----?---o----------------------o------B------oT----f
----------o--o----o|-------Mo-oo-|--------o--------o-------o---|-o-----------o-o-B-|-?--o--X-------B-o----oM---------XEo--E-|-----E--------M-----X-----o-------B----MX-oXo----o-Mo------oX-T-ooM--|----f
------------oo-B---|o------------|--o---Mo-E--------oo--TBB----M------Xo-----------B----o-oo-B-B------------B--------MB-o-M-X-oB--M--X--o----BX-o----------o-X----------------o---E-----o--|----o-|----f
-----M----------E--|-T--oXT------|--o-B---BM------o---M-|-------?oo-----------------o---o----o-----o-X---------o-----------T-o--E-----o---?----T-------X--o--------------E--------X--ME-o-X|------|----f
--o--o---T---B--T--|-|----|-----o|-X-----B---o----M-----|-o----------o----o-o-o-o---o--o--------oo-----M---------X---------|----B-o---------o--|oB------X-B----oo-X-----MM--o---------B----|----B-|----f
-------o-|-----o|--|-|----|------|------o-----------o---|o------o------o----------o-o----o--o------------------o-------oo--|----o---o--oo------|------------o------------------------------|----o-|----f
m------oo|---o--|--|-|---o|----E-|-o----E-o-------o-E-oo|-------o-----------o-o-----EE--E-oo-o-------------E-----E-----o-Eo|-------------------|Eo-Eo------E-oo-E---o-oo-o------Eo-------o-|----E-|----X
XX---XXXXX--XXXXXXXXXX--XXXXX-XXXXXXXXXXX-X-XX---XXXX-XXXXXX-XX-X---X-XX---XXXXXXXXXXXXXXXXXXXX--XX---X-X-XXXX-XXXXXXXXXXXXX--XXXXXXXXXXXXXX---XXXXXXXXXXXXXXXXXXXXXXXXX-XX--X--XXXX---XXXXXX-XXX-X-XXXX
