--------------------------------------------------------------------------------------------------------------------------------------------------------------------------------------------------------
-------------------O----------O-B--O--?----------------O--------------O-----------XM-------OO-O------------O--T-----------X------O--?----B--------------------X---O---------M----------OT---------------
--------------------O--------M-----X---E---O----------BX----X-------------O-O----------E---------------------XB---M--O---E--------------E------EEO---X---OM-----OO----B-O--O--------O--B|---X-OB--------
----------------O-------O-O-X----X-----BBE----B?-----T-----O----X---------E---B---O----B-O---?--B-----O--MOO-O-X-----M--OM-X-----O---E--B--O---XB-----OO-MO-----M---?O--TE--------------|O---O----------
----------------O-----OEO-----B----------BO---------T|-------------M-O--X-MO---OB--BB--------------------O----------------E------OT--T----O--E---------M--O---OO-----O--|BO---O-T--O-B-O|--B-----O------
--------------B---BO---X-----O-------------OO---E---||X--------O---------MEO-----------------O-O-----BO---X--O---E-----X--T--B----|-O|X-O-BOOB--O-----------------E-O-O-|---O?--M---X---|O--OT---O------
----------------O------------T---X--O---?--OO--OMO--|T--E--B-------M------X------------------O-------O-OO--------B-XB-----|-------|--|-------------O---XOO--------XMM---|--B---------XXO|---B|--O-------
----------------------------B|--O----M-----?--B---X-||--X-X-ME----X----O-------------OO-O--?---------------------------O--|--O-E--|O-|-?------------BOO-B-X---------O--O|-BO--X---E----E|X--O|O-MOO----v
--------------O----O---------|----O---O-O----------X||T--OOE-X-----------O?ET-----------------XO--------------------------|---OB--|--|----?B----EO---O-------O--------O-|------?O-B-M--X|----|---------f
--------X-OOO---------X------|--X--O---O-----------O|||----T--------OM-----X|O----O---O--------OX---O--O----------------X-|-------|--|-------B--X-X---------------X-----|----O---O---OO-|----|-O-------f
-------------B-------------X-|-----T---E-O----------|||X---|---O---------OO-|-----OBO-----B-M-O-O-O---OO----------E-----O-|-------|--|-X------MEOE-O-----?--OB-------E--|--ME------O--OO|-O--|----O----f
---O-------------?T-O---OB-O-|----OM---?------OEB---|||-O--|O----O------TM--|-----------O--------TMM-----E------O-B------M|----E--|BO|----BX---?-X--------O---B-M--M-M--|---M---O?----?-|----|?--O-----f
-----B---OO---MOO-|---X-O-M-O|O------X---------B-B--T||----|-X---OBOX---|---|-O-----M----O---OB--|----OX-M---X-M-B--------|M---BO-|--|O--------OX--X----B--O------?----O|XX--B---OO-----B----|---------f
-----o------o-o---|-o-------o|-----o--------------o-|||-o--|------------|---|--------o---o-o---o-|-----------------------o|-o-----|--|-----------------o--o-------------|-----o-----o--------|-o-------f
m-----------------|---------o|-o--oEEo--E---------oE|||--E-|-E--------o-|---|-o--------o----o-EE-|-----------o--------EE--|--E-E-o|--|----E--o-o--o---------E-------o---|----E--------E-o----|----------
XX--XXXX----XXX---|XXX--XXXXXXXXXXXXXXXXXX---XX---XXXXXXXXXXXXX-------XXXXXXXXXXX----XXXXXXXXXXXX|XX-----X---X----XXXXXXXXXXXXXXXXX--|XX--XXXXXXXXXX---XXXXXXXXXXXXXXXX-|---XXXXX---XXXXX-XXXXXXXXXXXXXX
