--------------------------------------------------------------------------------------------------------------------------------------------------------------------------------------------------------
-----------------B----O-----------------------------O------M-------O--------B---X------------M---E---O-E-----------------------O------------------------------?--O-EX--------OX-O------O-O-O---O--------
-------------X---O----?------O---------------------------------O----O-----O----O-O------T---M--BMBX----M---E--O---------M-E---------O----O-B----E--B--O------O--O--X-------M--------MO-----O---O--------
---------------M------------O-O---------O--M--------------E------------------E------O-B-|O-O---O-O------E--ME---------O---X--BO------O--OO-O--O-B--O----O---OO--B-------O------B------TO----O-----------
---------------------------------O---------------------X--M-?--------O---O---X------O-OO|O--------O--X-OB-O-?---X----------O--------M------O--O----OM--O------E---O--OO-M-------B---O-|E------B--O------
------------------------------O-O--O-----------X--------B-O--OO------X---EB------O------|E--------------E---O--MO-O-------------OO---------------------------OB-O--------B-------BE--E|T---OB-----------
--------O-B--------O--O---ME----BO------E--------OOXO--O-O-O--OO-B----BO-X-----O-O----OO|M-O-------B----?-----------O-E--OO----O-------?M--------X-------------T---?-----O-------OXXO?||--OXOB----------
---------------E-----B-X---M-------O----X-----X-----OB-B-M---OE-O-------O---O----XOM----|-----E-X--------------------XX---BO-----X-E--------T---------EO-------|------O---------B----O||-X-O-O---------v
------B--------B---E--X-----O-O-E-?-B-M----------OE---O-------B-----OO-------?OOX------O|---X-B--------B---OO-----O----EO-OO-O---O-X------O-|----O----M-OO---O-|----E------E----------||-------?-------f
--------------M--O-TO--------X--XO---X---OO-------M------------B--B-X------O-------O-E--|--------------O-------T-------M-------OO-----BOX-O-|---E----O---T----O|X---B-----MBX-O--M----||--MX------O----f
-----------------OO|--O--E----O-------------------OBO--O------E----XO------O----OO-B-X--|-O--O--T-----O----O---|O--B-M--?--O---O-------O----X---MOOO-----|----O|--------------------O-|X----B-----O----f
-----M-----?-------|-OE--X--M-XO------T------------------OEO--T--O---O-XX------O-------O|------O|-M--------TX--|--E-T-O--O-M-----O------OM-----------O---|MX---|-----?----------------|--E---M---------f
--M--------------T-|-MB---O-O---------|-----------------M-X--X|-X------O----B---O-------|-------|-------O--|-X-|-BM-|--------X--O---------------O--------|----B|----OOX---------O-----|O-?-O-O---------f
-------------o---|-|-----------------o|--o-o----o-------------|------------oo-----------|-------|----------|---|o---|------oo-------------------o---o----|-----|o---------------------|----------------f
m----------E-----|-|---------o-------o|--E---E---------------o|-o----------oo-oo--E----E|-------|--EE-o----|o--|----|----o----o------E-o--o-EEE-E-o-o-E-o|-----|o---E-o-o------o----E-|--o----o-oE-----X
XXXXXXX----XXXXXXXXX---------XXXXXXXXXXXXX-XXX-XX----X-------XXXXXXXXX--XXXXXXXXXXXX--XXXXXXXXX-|XXXXXXXX--XXXXXXXX-|X-X-XXXXXXXX----XXXXXX-XXX-XXXXXXXXXXXXXXXXXXXXX-XXX---XXXXXXXXXXXXXXX-XXXXXXXXXXXX
