-OO----O-------E--O--O-E--O--O-O-O--O--O-------O----O-O-----O----O-----OO-----O-O-OO--O---EO-O---O------O---OO-O-----O-OOO----OO-OOO---OE------OOO-OE-O--O--OO--OEO---------OO-O--O-O-----O---------O--O
--O--O--O-OOOOT?-O---OOXXEOMO-OBOE--O-EOB-OM-O-XOOEXB-O-O--O-O-O--O---BO-O-OB----O--TT--OEX--O-X----OOOO-B--OB--E--BEOX--B-B--O-OOTE-OO-MOOXO?O-OOOOM-OO-TXOOM-X-T----OBX--O-E-OOO-----OM--O--OO-O--M-OO
---O----OO---O|--B--?O---ME-OOO-MX--O-BT-O--E-TOE-M---X--O--O-----OMO-----M----O-TE-||OBM?-T-----OBEX----B--O-E-T-O-M-OO-OB--OB--O|B-OOOO----OO-----O-O--|O-OO--O|BXE-TO-OO--XOOTO-OO--?---MEB-BMO--O-OO
---O-O--OO-EB-|-O--OO?-O--B---------EBO|OOOOB-|EBO----O--O-O---X--OOO-OX-O--OOB--|XO||XO--O|OO--B-OX-O----??O-BB|-O-OM---XOE-----B|------OXOOEM-OO-O--B--|O-OOXOM|O-M-|-O-?TB-??|-------OOTOXOOO--XO-O-?
------OO-OOXO-B-OOOOO-O-------EOOOEMB--|-O--O-|?-OOOOBOOOOOBOO-O?O---BXOOO---B-ME|-M||----X|-O--OO-O----O---?X-O|----OO-O--BB-----|O-MO----E-BO-B----XOEOXXXB--O-|-X-B|O?O-|-EO-|-BOM-EO-O|OO-?O--OOOO--
----O-OOEOBOOM--BEB--OM------BX---?-OO-|-E-OETMO--XO--E--O--B-TO-X-OO-O-?OOO----M|EOB|OOB-O|BO-O-MME?EB-B---O--O|O----OBOO--OXXO?OXX-O-B---X-O-B-OO---OT-OOOOOOBO|-O-OB----|OTOOTX--O-T---|--EOO-XOOXO--
---OO--O?--O-O-X-X--O---MMM-EOOOOM---MOB-XTOX|O-B--OE-XTOX----|-O---O-OB--X-OOB-O|B-O|-BOO-|OO-B--OMOB-B--M--OO-|MOBO-BOOOO---------O-X-----T--OOBBM-O-|M-----MB-|MEOEOOOBOMX|--|OO-OX|O--|BOB--BO-MO--E
--O---XMOO--X-TO--O-OO-E---O?O--B---O-O-X-|OO|-BO---BT-|-O-XOO|O--OX--X-O----B--O|-O-|-E--O|--XOMO--O----X---B--|O-OM--O-E----OO-O---OO---M-|OO-EOO-OOX|---O-M-O-|OBXB-OB-MOO|O-|--O--|?TOM-E-OX--O--E-v
-O-O-----M---O|-X-X---EBO-OBOOO-----OO-O--|-O|-O-B-O-|-|?-X--?XOOOB-B--OX--------|OOO|-XBE-|OO--OX-----OB---OO--|--?---O-BO-O--?-BOM-O-BT--X|-B-BOEO---M-OM-----O|-O--OO-O-OO|BOBO-OOO|-|-OOT-M-OE--OB--
-OO--X--OXB-O-|O-BO---?-XOO---OO--O-OOBOO-T-XMB--OOO-M-|--O-O--OM----OO-O-OXO----|-OO|OXOMB|BX-X----OM-O----OO-M|OX?X--O------X-O-?OE-EO|M-O|--MOOMO--EB-EOO-OO-X|OOEOBB---M-|--O-OO-T|O|--B|EO--BTXM---
---XO---X--B-E|BOOE--?-EOTE---OOTBX-OOOX?O|?---OO--B--O|EXO-T--BO-OOEBMX-MTO-M-MX|-BM|-O---|---O?-BM-BE---O?OOO-|B-OOOO--O--OM--OE--T-BE|O-O|-OO--OO--?--BO--EO--|B-XBO-MBXOOB--O-BMM|BO|XO-|B-OXO|---OM
-OO-OEMOO-OOOBBO-OB---OB-|X-OOOB|--X---O-E|O---O--OX-EO|M-OM|-OOOXOO?---O-|--O---|-OOB-O-O-|-----O----MOXXOOOOO-B--OEB--O-OM--O--B--|--XXEOT|----O-OO--O----MXOEOB-----O-----O--EMOOO|-B|OTO|----O|--OBO
-OTOMB--?M-OOO-O--O-XOXO-|OOX-BO|-OOB--OOB|OB-?OOTBOOB-BBO--|--OTX--O-OO--|MMO--O|OO-OO-B-OB-MB-OOOO--O--OB-OMMXO?X-X-OTB-BOBOBXM-TX|O---T-|M-OOOXMO-OO--OMXO-XX-O--OOBO-OOX-O-XM-O--|-OB-|-?--XOO|OMO-O
--|----------------------|------|--o----o-|------|------oo--|---|---------|------|--------o-o-------o--------------o---|--------o-|-|----|-|----------oo-------------oo-----oo-------|--o-|o------|-----
m-|-------o---------Eo---|------|Eo-EE-o--|------|-----ooo-o|---|---------|------|---o----E---oooooE---------------ooo-|-------ooo|-|----|-|--------------------------------E-----E-E|----|-------|----o
X-|-------X------XX-XX---|-----XXXXXXXXXXXXXX----|--XXXXXXXXX-X-|------X--|------|---X---XXXX-XXXXXXX--------------XXX-|-------XXXXXX----|-|X--------XXX-X----------XXX----XXXXX--XXXXXXX-XXX-----|--XXX
