--------------------------------------------------------------------------------------------------------------------------------------------------------------------------------------------------------
----------------X--------o---o-----------------X----E-------------X--Xo---------------------E---------o-----X-o---oo--oX-B-M---M----o------?--------------o---B---X------------------?---M?-------------
-----------------BoB--oo-o-----------o---X------o---BMo-------B------X-o----o---------------X-----------?--o--o--oo--o-----o--E-----o--o----oo--------o--------------o-------Eo-----E-----?-o-----------
-----------------------B---o---T----oM---o-o-----B---o-o---o-----o-?o--X-B---EE----------Xo-o-o-----------------o-----oE--X---B------------------o---B------o------oX-X------M-M-o--B-E-----?---oB------
--------------------X------?---|---------o-----X-o?o------B-----o----o-------XTo----------To----------E---------Mo-----Bo--------o----------Bo--------------E-X--o-?-----Eo-o---------Bo--------o-------
------------------------oo-----|-----------------------E-----o--oM-----E------|-----------|-----B-----X-ME-o---o--M--EE-oB-----X-----o-----o--B------oo-----X---T----B--BX-----------M-------oX-E-------
-------------?--ooX---B---X----|-o---B---o------X------B-------o------oX------|-o--oX-----|-------X----?-T------oM-o-BX---o-o-------E-oB---E--------------oB----|-o-----o-----E-o-B----XE-------X-o-----
-----------------o-o-----------|--o-------------o-------B--o------X-------o---|B-o-X------|--------o---o-|----------------------Bo--M------M-B------oo--------oo|-o--------Xo-?--o-o----X--------------v
------------------oB--o--?-----|------T------B-o----------------------M--E----|o----------|-------o------|-E-o---------M--o-------------X---o------o----?---o---|-----------X-------------B------oT----f
--------o--B--------MoTB--o----|---B-B|--X----E----o----o----------X-----ToX--|---------X-|-B--------o-o-|-M---------XEo--E-----E-E--------M-----X-----o-------B|---MX---o----o-Mo-------X-T-ooM--|----f
----------------M--o--|------T-|------|o-o----XoX-----------B-o----------|-o-X|B--------o-|--o---E-o-----|M-Bo--E----MB-o-M---XB?-M--X--o----BX-o-oo--o----o-X--|----------o--o----o-------|----o-|----f
------------??---o---o|------|-?-o--B-|-----------Xo-------X-----o-o--o--|--o-|-----M-----|E-----M-TBo---|o--T-o?------------o--o-----o---?------------X--o-----|--------E-----B-----ME---X|------|----f
----------------o-----|------|--o-oo--|----oXo-----M----------o--o-----Xo|--?-|---o----M-o|B-------|-----|---|X-o-----------------o-------------oB-X-o--X-B----o|-X---BB-M--o--o---o--B----|----B-|----f
----o-o---------------|------|--------|-------------o---------ooo--o-----|----|-o-------o-|--o-----|----o|---|-o--o----ooo----------o--oo-------------------o---|------o---o---o-----------|----o-|----f
mo---------E----------|------|--o----o|----------oo-E-E---oE---oo-----o--|o---|---o-E--E--|-o------|----E|-E-|E-o-E----o--o---------------------Eo--o------E-oo-|---o----o------Eo-------o-|----E-|----X
XX--XXXXXX-XXXX-XX--XXXX-----XXXXXXX-X|-------XXXXXXXXXX--XX-XXXXXXXXXXXX---X-|XXXX-XXXXXX|-XXXX--XXXX--XXXXXXXXX-XXXXXXXXXXX-XXXXXXXXXXXXXX----XXXXX-XXXXXXXXXXXXXXXXXX-XXX-X-XXXXX---X-XXXX-XXX-X-XXXX
