--------------------------------------------------------------------------------------------------------------------------------------------------------------------------------------------------------
---------------T------M--O-O----?-----T-----O---------------------------------X----O--------X-E--------B-----O-------O----O-X---------O--O--O--------B--O---------B--------EX--X------M----------O------
---------------|---?-------O----------|--O--OO---------M---------------EE-O----------M-----O--B--E---O-------------OO------O-----?-----------X-------O-----------M---OO----M----M----O------------------
-------------TB|X--------OXT-----OO---|B-E-O--------M-------XO-O-M----TXM--O------------------OO-T--O-----O--T--O-O--------O------O-EO-XO----O-----------O-----T----------X---O------O-------B----------
----------E--|O|-----OM---O|--O-------|--XO---------O------O----------|O----X---------O----------|---OXB-----|M-?--O----X---X-E---X-X----X---------B-----O----O|------?-?---T------------O-O--X---------
----------B--|-|-BEOBX-----|-M--X-B---|----------------OO--XO-B-O----X|----B-M--M-------XOO---O-M|---O-OO----|-B-O------------TO-----------------OOO-O-O-OO?---|---B?-------|--------O----?-E---O-------
-------------|-|-OXX------O|O---------|B------------------X-?--------O|-----O----?----BO-----M---|----------E|-XO----O--------|----O------O-OOT----------------|-------OO---|------M-M-O--O-X--O--------
--------O---X|-|-O---------|B--------M|----EB---------X---O-----------|-M-M----B-----------X---O-|O-----X--OB|----M--O--O---O-|--------X-----O|------O---O-----|--------B---|--O-----O--O--O-X---------v
-------M-OT--|-|-O---O-X---|--O-------|X---T--OO-------B----O--O-O--X-|O---------------OB---O----|O-X-X------|--T---------OO--|--E----------O-|-------?OOO---M-|--------O---|-?O-----OO-B-O----O--M----f
----------|--|T|-----------|--M-------|----|--BOO--------E-----------B|---O----O--OO-B-M--OO-T---|-O--O--O---|--|----O-----O--|--?---------O--|-----O------TX-O|-----BE-----|----O---M-B--B--O---------f
----------|--||XO--O--M--T-X----------|O---|----X--OB----?E-----------|-----T-----B---O------|E--|----O-T-O--|--|M--X----E----|------MOOO--?--|-----------O|---|XB---OT-----X---M-O--O-----------O-----f
-----T----|--||-------OO-|-O?---------|B---|-----X--------MO--X-------|--O?-|---------O--M---|MO-|--?OM-|-B--|--|----XE--B----|-----------OO-M|-?--O-EO----|---|O-----|--B-------E---O---------EO------f
-----|-M--|--||--XM?-----X--O-O-------|--O-M--O----O-O-?--------O-----|-O---|-----O-X--------X---|----O-|-OB-|--|O----B-------|?--O-----------|--X---MOO---|-B-|O-----|---------OM--O----O-----M--O----f
-----|----|--||-o------o-----o---oo---|-------o--------o--------------|-----|------o--o----------|------|--o-|--|o-----o------|----------o----|-----------o|-o-|--o--o|-------------o------oo--o-------f
m-o--|----|-E||o--E-------o--EE--Eo---|--------o-------o-E------------|-----|--E-o-E---E---------|-oEE--|o-o-|--|-E----oEo----|-o---E---------|-o----Eo-o--|---|o---E-|--------------o-E--o-o--o-------X
XXXXXXXX--|XXXXXXXXXXX-XXXXXXXXXXXXXXXXXXXXX--XXXX-----XXX-XX--X------|---XXX--XXX-XXXXXXXX------XXXXXXXXXXX-XXXXXXX--XXXXXXXXXXXXXXXXXXXXXXXXXXXXXXXXXXXXXXXXXXXXXXXXXXXXXXXXXXX---XXXX--XXXX-XX----XXX
