--------------------------------------------------------------------------------------------------------------------------------------------------------------------------------------------------------
----------------------------?------------------------?--M---------E--?--E--------B--o-------------oo--E----X---------------------oo----o----o--------X----o-------X------------B---------M?-------------
--------------o-----B-------------------------o-o-M-----o------B--?-----M-E-E---B----o---oM------o-E-oB-----------------X?-----------------o-o------o----B------o-------------------E-----?-o-----------
---------------BE------o-----XB--X-oo-o----------?-------o-----o----------XoT--------------o-----M-B-------------oo---------X---o----o-E---X-------o--E-----oE-----oX-X----------o--Bo------?---oB------
--------------M-B------o----------M--X--------X---E--------o--o-----------o-|----o-----o---o--X-----o--o-----o----ooo-----o---B--X-----B------o-E---o-B-Bo---X---o-?------o-o---------o---------o-------
-----------o?-o--------X---------o------E----o----M-------o--ooT---------Eo-|--X-----o---T---B---oB-----------o-------B---o-------------o-o---o-M-----------o---X--------------X-------------oX-E-------
------------o-o----o------X-o----------oT--o-B-oMo----X--?---E-|--------oX-o|---o--oE--o-|X--o------------B---------o-------------E---o------oo-------o---oB------o--o-----------------oE-------X-o-----
------------o-M-o--B--B------X-----oX---|------------X-------M-|---o----o---X----E-oX----|o-Bo--------o----B------------o-----o---B-o---------o----o-?---o----ooooo------E-Xo----o-o----X--------------v
----------B------E---M------o-o----o-B--|Bo-E-o----o----------o|---------o-o----BM---o-oX?-------------o--------T-------------------Xo-B-X---E--o-----B-BM---------------?--X-M------o----B------oT----f
------X-o----o-o-BX---E---E-----o-------|---B-------o--------o-|o---X---------o----MooXE--oo-E-o---------o------|------------o--oo--------E--M-o--o--o-oBo---T-B----M---o----o-o-o-------X-T--o---|----f
----------o-----------BE--T----------E-M|-----o------o---------|------ooBX----o-------oM-----B----------EE-o---o|--o--X--o---B--X-----o-o-M----------------o-|-------------o-M----Eo--B----|----o-|----f
-----o-o--------oo-X---?TX|--------B-BooX-------XE------B--o---|-----oo-----o--X-----X----o--o---o-B--X-BM-E--o-|--EE--o------X---------B---M---MM-----X--o--|---M------------B---X--B-?--X|------|----f
---o------o-------B-o--o|-|o---oB----o-----o-T---M----oM-----o-|-o-----T-------o----o-----X----o-------B-o-?----|--XB-----------------M----M------o-------B-o|-o--X--oBB----o------o--o----|----B-|----f
-o----------------------|-|------------------|----o-----o------|-o-o---|---------o----------o-----o---o-----o---|-o-o-----o-----o-oo-----------------o------o|o-o------o---o---------------|----o-|----f
m------oo---o---E--E----|E|-----o-oo---------|-------E--E---E--|----o--|---o-o---E-----------o--o----------o-E--|--o-o------E----o----E---------o----------E-|------oo---------Eoo---o---o-|---oE-|----X
XXX-XXXXXXXXX---XXXX--X-XXXXXX----XXXX--XXX-XXXXX-XX-XXXXXXXXX-X-X-XX-X|-XXX-XXX-XX-------XXXXXXXXXXX-X---XXXXXXXXXXXXX---XXXXXXXXXXX-X-XX-----XXXXXXXXXX-XXXXXXXXXXXXXXXXXX----XXXX-XX--XXXXXXXX-XX-XXX
