--------------------------------------------------------------------------------------------------------------------------------------------------------------------------------------------------------
----------------------------E---------------?---E-----?---X----X--oB--------------o-------------------------------------------o----X------o------Xo----o----X----------M-o-------o----------------------
----------------M-E--?-M----B-----o--o---TB-----Boo--X-----------------M----------o---o--------o---o----o?-------------------------o---------o-----------------------B--------o---TB----o--o-----M------
------------------?--o-----Eo------o-----|----o--X-M---XB---------o------o---------------------------------------o-----o--o--X-----?-oo--X--oo---------oB---------B------B-----o--|-------X-Xo--E-M-----
---------------?---o-o-M---X---------o---|--T----o----o----B--------------X--B----o--MoX------------------B--o-o---------o----------------T------------?o-X-----o-------o--o-----?|----------o--T-------
-----------------------Bo-X--------------|--|--oX------------o------o--------o-------oo--?-o--o-E------B---o-------X--Eo----E---E-------o-|-T--o------X-------------T-oo---?------|---o-----E---|-------
-----------------------oX-----To-o--B---X|--|--o----M-X-o-E------B--------------o-?M------o-o---X--M--------------E--oX-o---B---To--o---E-|-|----E--X----?--X-------|Bo-----------XM-o---B--?--o|-------
---------------------X--------|-o----B-o-|o-|-----Bo--o---M-----------o-----------------B-?o--------oX---M--------X--M---E-----?|-E-----B-|-|-o--?--oM-o--------o---|----o-------o------B----o--|------v
---------B-o--------------XB-o|--o-E-o---|o-|-M--------X-E-------o---------o-M-o-----oo-------E---oo---T--o-o----------MoBX-----|-?B---T--|T|-------oooB--------o-o-|-Bo-----------E-M-o---o----|E-----f
--------o--o-------------M----|-o--B--M--|--|o---o--T----M--oT----B---B----BM----------------oB--oX----|--E---------------------|--o---|--|||--Eo-o-E---oE---E-X-?-o|--------------X--------B---|X-----f
---------o------------------o-|----o--EBM|--|---o---|--------|o------o--------o--Xo-----o----o-------T-|--M-------o---oo--------|------|--|||--X----Bo---B---?------|----o----------X--o---M-M--|------f
-----------?E--?--?------o----|--X----B--|--|-------|---Xo---|-M-----o----o-------------E---T-----o-o|-|---Eo-------o---E--oM---|-o-M-o|--|||-------o--X-----o------|B----o-----------o-----o---|------f
------X--X--XX----o--X--oo----|----o---o-|--|---o-BX|-------X|---------o---------o-M--o-M--o|---o----|-|-X-B-M----o-----XoX-o---|-oo---|?-|||----X---o---------o-oo-|o--M------------------o--o-|------f
-o------------------------o---|-------oo-|--|--oo---|--------|-------------o-o--o-----------|--------|-|-------------o---------o|-o----|-o|||-----------------------|----------------o----------|------f
m------E--o---------------o---|--EEE--E--|-o|--o-E-E|--------|-o-----o--o-oo-------------o--|o----o--|-|--------ooo----------o--|------|E-|||-----------o----oEo----|--E---EEEo-------E-E---E---|E-----X
XX--XXXXXXXXXXX---XXXX----XXXXX--XXXXXXXXXXXXXXXXXXXXXXXXXXXXXXXXXXXXXXXXXXXXXXXXXXXXXXXXXXXXX----XXX|-|---XXXXXXXXX-XX-XX--XXXXXXX---XXXXX|X---XX----X-XXXXXXXX----|--XXXXXXXXXXXXX-XXXX-XXXX--XX-XXXXX
