--------------------------------------------------------------------------------------------------------------------------------------------------------------------------------------------------------
----------------------OO------OO--M--?-----X--------------X------E-XO----------E------O--O--B-------------------B------EO?-B----B--------O--------X-XO-----B-B----------------------EO-----------E------
------------------O----------------X-OO----------------EO-----O-BX--X----OO-O--X-----------B--O-OO-----O-----O-B------OB-O--------B----O-X-B------X--E------OO---------E---E----O---??---B----OO-X------
----------------O--OO--O---O----O-------------X-X------B------------O--O---------M-----------X-O-O-OO-------B-----O---M--------------M------E-O------BE--------------O-X--BB---BO-----------------------
--------------O-T--X-T-O---O---------O--OO-X---X------------E--OO-O--O---OB-----BO-------O--O-----O---O---E--M-O------O-B-XBE-XX------X-----B--?----O-X------O--O-------O----O--B-E-O-------O-X---------
--------O-------|-X--|--OTO---B------O-------------O-O-O----?B---?---O-X---------------O-M-O----X-M-OO----X--O---MTX---OOO--T----?--O------E--------------E----------B------------B---M-X--O--O---------
-------------T-O|-O--|--O|--O--O-------M------X---TB--------O----O---------O-O-O--X-E-----B---------OO--O----O----|OO----B--|O-E--T--------X-------O-----BBB-OB-O--OB-----O----E--O-?MO-----------------
---------E---|--|----|OO-|-T-------M--------------|----O------X------O---O---------OM-X-O-O-O-----O-----?---------|---O-X---|O-X--|-O---X---X----M-O--X------------O-XO------O-BO--B--OT------O--------v
-------O-X---|--|----|---|-|----------------M-----|OE------------EO------------------E---OO-----XB-------B--O-O---|------O--X?O-X-|--M-O-----O---O---------O----B------O--OO--B--------|-----B---------f
-----M-------|--XO---|---|-|--X-----------------X-|-BX------M----?-----OO----------O-B--TB----O---E-----OO-----O--|-----O---O-----|-----O--BOO--O-O----T---E------O------B-M-----O-X--B|O-O------------f
-------M-----|-------|-OO|-|---X-------O---------O|-O--OX-O---O----EX-------T--OB------O|-X--O--O-T-------O-B-----|-------?---O---|O--OOO--------O-----|--OB----E-O-MO--O-OO--O--------|-----O---M-----f
----B-O--O--O|X------|---X-X------------O-----E---|--O----------OOXB-O--O---|---------O-|OO------O|X---TO---O---B-?-O----O---B----|----O-O-------O-----|B-------?B------O----------XO--|--------X------f
---BO-O-X----|-------|-T-----------OTM----X---M---|--------B--------O---OO--|-----O-O---|-----O-XT|----|--------O-----------------|--OO---O--X---X-----|---O-O-M-O-----OXO---------O---|----X----------f
-o-----------|-------|-|------------|--o-------o--|----------o------oo--o---|-----------|--------||----|---o---o-o--------o----o--|--------------------|----------oo---o-----o-o-------|----oo---------f
m-oE---oE-o-E|-------|-|--------E-E-|---o--o-----o|----o------------o--o----|-E-----EE-o|E-oo----||----|------E-----------E-------|-----E-------Eo---Eo|-----o-E-o----ooo---o---o-E---o|-o--o----------X
XXXXXXXXXXXXXXX---XXXXXX---X----XXXX|--XXX-X---XXXX--XXX--XXXX----XXXXXXXXXXXXXX-XX-XX-XXXXXXXXXXXX--XXXXXXXX-XXXXXXXX----X-----XX|--X-XX-XXXXXXXX---XX|---XXXXXXXXXXXXXXXXXXXXXXXXXXXXXXXXXXXXXXX--X--X
