--------------------------------------------------------------------------------------------------------------------------------------------------------------------------------------------------------
-----------------------------------O-O---------O-O-------O----XX----------O--------O-----?-O-X--E----X-----E-------O--------O---M------E---?-----------?----?-O----O-----B---O-O---E---------T----------
--------------------------------------------B-----O-?-O----E-B----M-----O-O-B----B--M--O--OO---O?O----X---BM-----X---O------OB-----O---X------O-X-------M--O--O-M---B------------O-B?------O-|--OB------
----------------OO----------------------------O------------X-----EOO-O--O-------?-O---B-B-----O-------------O----------O-----------E-O--------------------------------MB-O-B----------------B|----------
-------------------OM-------O-OE-O----O----------M--O-O---B------M-----------O---B-B-----E--X------O----------------O------O-----E-X-O---OO--------M-O--E--?O?--O--O----------B-B--OO----E-O-|?BO-------
----------------B----OO------B-XO---------TO-------O-----O--------O--OOO--O---X-------EO-M--------------X------X-MO-X------X-B---M----O-M--O-O--O---O---B------O------O-----------O-M----BO--|---B------
--------------X----------O--O-------------|--------B--B--X-----M---O-X------B------O--M---OOOO-----O-----E--------T---------E--O------O----O-O------------OOO--O-----O--OOB--X--O----O-O-----|O---------
-----------------------BO---------------EO|B---E-M-O--------------------------------O--O------E----O-----X-OO---O-|---------X---------------------O--O-B-X----O-M-----O-----------E--------O-|---------v
----------O------OO--M----X------B--B-XOM-X-X--M---O---EB-OO---------OO----O-X--O---------OO--X-T-OO--E---------XB|----MOB------O-----X-O------?------?-O-T---------------OB----E-X-O--E-EO--|-OT-O----f
-----------EX---OO----EO-O-----------O-----------------M-O------O---?-B--------------O-XO-----O-|---OOM-----E-----|-----O-OXE-------M---O--E--------------|X------EB-O---O----X-X---O--B-B---|--|M-----f
------O--OEX----------T-E--MO--E-O-----------OO---E-E-------E----EO--------M--E----BOMO-MX------|------O---XM-O---|-------O-B-O--O-----OOO-X-O---BE---OO--|--B----B------O----XO--O--M-----O-|--|------f
---O----O?X-------O---|OX------BO-------M--O-O-X--M-X-------?--O-BO-----------X--------------T--|-TE----ET----X-O-|--X------M-O--B-------B-O-----OT-BOOX--MO--O-----------------OO----O--O-O-|O-|O-----f
-----X--B---B--------O|------X-----B-----------O---OO-----O---------------MO-X---O---O----B--|-X|-|B-O--M|--O-O--OX?-O--OO-O----O---X--------O--B-|-----?------B------O---------T-----?--OB-O|--|------f
-----------o-----oo--o|---------o-oo--o------------o--------------------oo----o--------o-o---|--|o|------|-o------o-------oo-o-------o------o-----|--o--------oo-----ooo--o-o-o-|------------|--|------f
m---E-E--o-o-o-o--o---|---------------o---E--------------E-o--o----------o--------------o-E--|--|-|-oo-E-|-------Eo--o--------oE-E---------o--E---|o----o------o-----E-o----E---|-----E---o--|--|-------
XXXXXXX--XXXXXXXXXXXXXXXXX-----XXXXXXXXXXXXX-----XXXXXXXXXXXXXX---X-----XXX---XXX-----XXXXXXXXXXXXXXXXXX-|-XX---XXXXXXX---XXXXXXXXX-XXX---XXXXXXXXXXXXXXX-----XXX--XXXXXXXXXXXX-|--XXXXXXXXX-|--|--XXXXX
