--------------------------------------------------------------------------------------------------------------------------------------------------------------------------------------------------------
--------------------X-o---E----o-------------X--------------T-o----o---E-----------------?o-X-o-o----------o-----------------------X------M-B-----o---------X----------M-o-------o----------------------
----------------------o---B-o--oB----oo--o----E--X---------B|----o--?--B------X-ooX----------ooo--oo----oB------------------o------o---------o-----------------------B--------o---TB----o--o-E---M------
-------------o-o--o----------o------E-X-M--o--M-----o----X--|X-B---T------?-TTo-------X-o-------o----------------o--------o---o----?-oo--X---o----------B---------B------B--------|-------X-XM--E-M-----
------------o---X-B-----o---M-------B---------o-----o--oo---|------|o-------||---------M?---o-o--o-----T--B--o-o------------B------------------X-X------o-X-----o-------o--o-----?|-------------T-------
------------o----------o--X-------o---E-------o----------o--|-ooo--|-X-o----||-----o--------B-----o----|---o-------X--E------o--E-----------o---------X-------------T-oo---?------|---oo----Eo--|-------
--------------T--M-----B--------B---o-B-------------?-------|-o---o|--o-o---||X---E---------------o----|----------E--oX-o-------To--o---------------X----?--X-------|Bo--------o--XM-o-o-B--?--o|-------
----------XT--|--o----B---o--oo--B-----------o-o--B-----o---|-----o|oo------||----B---E-----o----E---X-|----------X--M---------?|-E-----------o-----oM-E--------o---|----o-------o------B-------|------v
-----------|o-|----------?---E-E-----M----X--B-X-o----To----|----B-|-o-T--o-||-T------X-------o-o?--o--|--o-o---X------Xo-X-----|-?B---T---T--------oooM--------o-o-|-Bo-----------E-M-----o----|E-----f
----------o|--|--------------M-Bo-Boo-------------EBoo|---o-|--o---|---|----||o|----oX-?---X-B-o-------|--E-----o------------o--|--o---|---|----o-o-E---oE---E-X-?-o|--------------X--------B---|X-----f
--------B--|B-|----oo------o------X--------o---E--X--o|-o---|----o-|---|-o--|X-|-o-o----------------oT-|--M-------o---o--o------|------|---|---X----Bo---B---?------|----o-----X----X------M----|------f
----X----o-|--|o----------------o-o--X------o--M------|-----|?-----|---|----|o-|--------o-Eo-----o---|-|----o---B---o---E--o----|-o-M-o|T-T|o-------o--------o------|B----o----o------o-----o---|------f
--o---B-oM-|--|oo--------o---X---B----oT---o--Bo----B-|oo---|--X---|---|----|--|---M---o-XBM---Xo----|-|-----M----o-----X-X-----|-oo---||-||---------o-?-------o-oo-|o--M------------------o-oo-|------f
-o-o-oo----|oo|o-o---------------------|--------------|-----|-o----|---|--o-|--|--------o-o----------|-|-------------o---------o|-o----||o||-----------o---o--------|----------------o----------|------f
m---o-----o|--|E------------oo----o----|-----------o-o|E----|---oo-|---|-oEo|--|------------E--------|-|---------oo-------------|------||-||-----o------o----oEo----|--E---EEEo-------E-E---E---|E-----X
XXXXXXXXXXXXXXXX-X----XXXXX-XXX-XXX---XX-XX--XXX-XXXXXXXX-X-|XXXXXXXXXXXXXXX|--|XXX-----XXXXXXXXX----|-|---XXXXX-XXX-XXXXX----XXXXX---XXXXX|X--XXX----XXXXXXXXXX----|--XXXXXXXX-XXXX-XXXX-XXX---XX-XXXXX
