--------------------------------------------------------------------------------------------------------------------------------------------------------------------------------------------------------
-----------------------O----O-----O---M-------------EO---O----B-----------------O-M----------------------B--------OB--X---------------X--------------------------EO------XX--OBO----------TO-----O------
----------------?-----------------X------T-?--------MO---X--------O------O---O-----O--M-------O------------O---B---------------O--------------O--X------------O--B-O--B---O------M-O---M--|------O------
-----------------------O----B------------|-----OO-O------X-X---O-----------------O-------------E--------M-----O--------E---------M--XX------O-----E-O-------OO----------------------O---BE|O-B---E------
--------------O------XB-----O-B-E--O-----|----O--X?-----O----O--B------------E-----------------X-------X---XOX------O--B---O-O----------O---------X-O-------------BB----------------M----MBOO----?O-----
---------------B--BO-O----------T-----O-O|-O-O-------O--M--O----------O------B-TO------------M----O--X------M-------EO--------------------M-------------------T-O-------O-X----------E------------------
-------------TOOO----O------BM--|O--TO---|--E--O----MB--OM-XO--O-----X--B-----?|---O-------TO--O----O-----EO-O------X-------------O-----O----BB--------X----X-|O---O-----?-----B----OM--OX--------------
------------O|-----O-O----------|O--|--O-|--X---O---------E--X--------O-------OT--O---O----|--O---E-------M------B-O-O------------O---O-----O-O-M-O---------O-|O-------------O--X-------------X--------v
-------------|-----O-----MO-----|---|--?-|---------O---X--M-----X---O-OO----E--|--OO?------|-O-O--B-OO-O-O---O-O---M-T---------O-----------O----------O-?-----|---O----B--O---O-------OM-O----OM-------f
----------T--T-O---E-E----------|-O-|----|O----O-----------BM-B----O--------M--|-E---ME-M--|OO---------E----?OX-----O|-BO--E-----------OB-T-B-------X--O------|--------------O---O-O-------?---O-------f
--------O-|--|-----B-X----------|BE-MT---|XX---BT--?--O----O---O--T--O---------BOB----?----|-MOOO--OO--B---B---M-----|XO---?----X--B-B----|--B--B--?--O-------|-?---B-----X--E--B--O-----MO-------O----f
----------|--|---X--B-----O-----|-X--|-XX|O----O|------EO---O-O--X|----XO-X---E-------O--O-|---E------O--------------B-X--?-----------O---|E----O---O-O-----X-|-----------O--X----------O-----OO-OE----f
--O--X----|-O|-?------OOTX----B-|----|---|O-----|X---XOB---------O|--------M--B-----B--M--O|---X----M---O-O-X-O----------X--O--OO-O------M|BO----O------XTB-O-|X-M-----M----O---------B-----O----OB----f
----------|--|o---------|--o----|o--o|---|--o---|-----------------|-o--o-o-------o---------|o---------------o---------------o--o-----o----|o-o----------o|-o--|-------------o--------------------------f
mE--------|o-|----------|Eo-o--E|E---|-o-|-o-oo-|------o-----E-oo-|E----E--o---------------|o------o-E-o------E------------o--Eo------Eo--|-----oo--o--o-|--o-|-E-----E-E-o-oE----o------E--------------
XXXX----XXXXXXXXXX----XXXXXXX--XXXXXXXXXXXXXXXXXXXXXXXXXXX--XXXXXXXXXXXXXXXXXXXXXXXXXX---XXXX-----XXXXXXXXXXXXXXXXX-----XXXXXXXX-----XXXXXXXXXXXXX-XXXXXX|-XXX|-XXXXXXXXXXXXXXXXXXXXX-XXXXXXXXXXX---XXXX
