--------------------------------------------------------------------------------------------------------------------------------------------------------------------------------------------------------
------------------------------X-O--O--O-O-----O-----OB---------OO------------------------O-----O--T-----------E--------OO-------?-M-----MB--B-------O---------B---O-T---B----O-------------------O------
--------------E----------O-------------------------------?X--X-----O-E---------O--B--------O--B---|----O----E-MM---------XO---------------?---------OO----O---------|-O--O---O--------EO-X-------B------
-------------OXO-----------------E-OE--------OOM---------------------?---O-T----O----------O-E----|-O-------M---O--?---OE-------O-O--------X------O-B--O------E-----|-?O---T------O---X-----------------
-----------O---------------EO--OXB--X------T-B------O--O--O---O--?----B----|-----?--O--------T--B-B-X------------M---TE-X-------X-------------O---------------M-X-BX|O-----|-------OB-------------------
--------------O-----------OX---O-----------|-------------BO---O-M--------O-|------O--B----X--|-O-----XO------------O-|B-O-O-------------E--------T--E-?O------OO----|------|------------O----X----M-----
---------B---------------B-----X---O-----T-|---------TX-E--T-?X----O-------|---------O-X--OO-|-----------O--E----E---|---OX----------O--M--------|O-M---M-O----?----|-B---O|-----M----B-------T---------
--------O-------O---O-------B---B-------B|T|?X----O-X|-OB--|------------E--|----?---------B--|-------OT-----X----XO-O|--------B-----B--------O---|----O-----OO----M-|---O-B|-------O--O---O---|---O----v
-----------O----X---------OE---X-O---M---|||O--------|--O--|------OB---O?--|M----T--------O--|--------|--B-O------O--|--------O-OO---O--O-X--O--O|---O-O-----------O|-OO---|-O----O--B--------|--X-----f
-----OE---O----------B-B-O-M--O---O-O-BO-|||O------OO|E----|O----T---------|O----|-----------|-------?|---O----------B-O----O-----OX-------TX----|--XO--T-MO-------EB------BMO--O--------XOM--|--------f
------?--M--------OX-O--O-O---------O----X||------OXO|B-?--|-O-O-|-E-M---O-|B-O--|E---O------|E-------|---------OO----------B-O----O---X-X-|-----|-O----|--M-------M--O-----------O---O--O----|O-------f
---X---------M-------O--O----O--------O-O-?|E-------B|-B---|----O|-MBB-----|----O|B----OE----|X--XEO--|---O--O------X-O----OX--X-XX-----O--|-----|------|--------X----O------O---E-----E--X---|O-O-----f
----------X------------------XX--B----O-O--|T--------|-----|-X---|----O----T-----X----O-TOOO-|----M---|-O-O----O--------------M-----OB--XO-|----O|------M-------------X-----B----BOM-O-?------|--MB----f
-o--------------------o-----------------o--||--o-----|----o|ooo--|--o------|---o--------|--o-|----oo--|-------o--------o-----------------o-|-o---|-o-------------------------------------o--o-|--------f
mE----------o---E-----E-E------o-----E--oE-||--o-----|---oo|-----|-----o--E|--o-o-----o-|----|-------o|E-o---o-----E-E---o--E------o--E---o|----E|---o-----E--------o--E-------oE--o---------E|---------
XX----XXXXXXXX-XXXXXXXXXX--XXXXX----XXXXXXX||XXX----XX--XXXXXXXX-|--XXXXXXXXXXXXX-----XXXXXXXX----XXXXXXXX-XXXXXXXXXXXXXXXXXXXXXX--XXXXXXXXXXXXXXXXXXXXXXXXXX-----XXXXXXXXXXXXXXXXXX----XXXXXXXXX--XXXXX
