--------------------------------------------------------------------------------------------------------------------------------------------------------------------------------------------------------
--------------BBMX-OB--OOE-OB-OXO---EBEEOO--EOOBE--B--XOO-OBX-OE----OM--TOB---OOO-O--E-EX-M-B--EM-EE--OO-O-OE-EOMEO-O?-MBBTMOXMOOT--EEE-OB--O--OB-O---------O-EOE---O-O--MOXO-OO-O------O--------X------
--------------O----B--O--O----O-B-O-E-O-O-EBET-O-BB-OEO-----B--EMOEOE--OO-O-OE--EO-E-MMT---O-TO-MOM----OO-EE-OMBOBOOO-O-BOX--O-O-O--OMXO-O----E----EO---------B-----MBE-O-O--O-E--EOO--E-----O-O--X-----
-----------B-----O-OEXT--EE-EO-OOOBOOO--OEE-?O-B-O-O------OO-O-OOEMOMOOO-OEOOMOO---XEEOO--BOO|OE---B-OE-O----?-OOMTOXOOX--OO---O-|EOB--OOE---EM-OE-B|O-TB---EM--X-OB-B-OE---EBO-O--EO-MB----B-----------
---------------E----E--EBMM-BBEMO---O-B-OBX--O--OEO-O--O--O|OMXOB|-?EEOE--BXOO--EOOOM-EX-X--XBOOO-EM-EXOB-E-X?OOO-|OOEE-OEO-EOXMOE?M---O-XO-OXO|O|OOO-O----MXTO|-O-----OX-O-B-M-OO-OOE-E----------------
---------|?X--OXX-OOMOO-E-OE-EXOE-OOOOO|E--OE|-OOMOB-EO---EBE-OBOOX-BXOBOMOOOOOO|OBO-O-BX---OO|-OB--TTOX--|OOOOO--|O-BE--BBOMBXEO|OO-B--M--B-OEEEX---O-----EO-O|MO--X---O---OOOE-E|OO-|-------EO--X-----
--------EO--E-O-O--OO-|XOEB-OOEOXXOE-O---O--OOOEOOB--OOOOOB-EO-BXO--OE--OO-|OX-MOEO-O?-|OOOOTMT--OBO-|--EX-M-OOM-O|BOBBE----OOO?-OOO--OEOO-OO-MO-E--O-OOO----|O|--------E-OOE-O-OXOO-OBOX--O-OEM--------
-----------TO-X|-X-TMB|EOBEOEO|OX-O?-OOE-OO--MO-O-O---XBO|O--EOO---OEOOOO-XEOB-OOBO?O-EOMTTO|-|--OO--O?OO----MMO-OXO--OXOOO-BOE---OOO-OB--EEBB--OO-?OOX-||--E--|O--O--E-O---BBO--O|--O-O-?---T----O----v
---------|----|X--X|-OOM-E-XOOOXX-OXOXO--BB--EE-E-O|-EEO-MO--MT-O-O-BEM-OXE-OOE--OEMEOOO-O-O|T|-B-B--|-BO-OOOOO---OOE-O-E|---XOXE|O-OEX--E?OOOET-|-OO--OEB---?X|--O-O|X-X-O-OB-ETO|--OO-ME-----O-B------
------|-OO----|-OOO|EO|OOMEBOOEX-O--BXB---OO-EEOB-ME-T|EE-E--OEOOB-O-XO-XOOOBOMT|-T-M?OB||OE||EO---X-XO-|MOBO-X-BOO?X-E-X--OO--OX-O-?OOE-OMO-----EOE||--|----------O----M-O-OBBO||EO-O-----O-----B------
-------X--X-M-BO|O-|MX|XMOMOEO|-OOOE-OBOO---OB|-OO-EOOEO-OX-O-E-XB--O--O-O-O-X|---EOM---E|OB|M|-|O---O-E-OO--O--OO|OOOB?|BOB-OEOO|--O--XO--X---O-OOB-OM-OO----|MEO?XO---O-B-XB-||O|---B------|----------
----E---OOX---X-T--X-XE-?XOE|-B-EOO---O--M--?X---M-OO-|X-O-XXOOOOOXO--OMTBO-OB-O-B|-TOE-||OEX-|OOOO-OXX--EEOO-OOOXO-EXOEO--OO-X--E-X-OBXOO-O||-O-?-O--EO-BE-EX|--------OO-O--XO|B--OEO-?E?O-O-----------
----?--MO--OOB-B--BO-X---OETOO-T-?O-OBOBT?B?-|-?-O?O-EE-O--OBEBEO-XOX-MO|O-XEOMOXOE|-BEME|E?-BE-|-X-OO--|TXBOTX|BOXMM-E--OMO-O--O?EMO-O------M-BEE-EMO-MO-MO-OBT---OX|--OB----OE-OE-OOO-------B---------
-----oo|-|---|--|-----o--o|----|----o----------------|---|-----|--------|---|----o||--|-|||--||o---------|---|-o-o----|---o----|-o|--------||----|--o---------|-------oo--|----|--|--------o---o-|------
m-o----|----|------o--|-|oo-|Eo|--oo----------o|o-----|--|||-o-|-------E|----|------|-|-|-|---|-----------E-o|-|---|----|-----o-E--o----oo---------|-----------||-----o-----|--|-|------o---E---E-------
XX--XXX---X-----|---------------------|---|XX---X----X-X----X|-|--------|--------------------------------|---|----------------------|----X---------|---|---------------X-XX---X------X--X--X--XXX|--X--X
