--------------------------------------------------------------------------------------------------------------------------------------------------------------------------------------------------------
-------------------oo-----------Eo---o--------Bo-------------?EB-------X-------E--E------------------------------------------------X-----Bo-B----Xo--------------------M-o-------o----------------------
------------------oE--X-------o-BMX-o-o-----o---------o-------M-o------------oBT?EM-----oo-o------------o------------o------o------o---------o-o---------------------M--------o---TB---oo--o-E---M------
-----------------o-B---------------B--M?o-------o---------o-ooo---X------o-----|-B--?---o---------o-B------------o--------o---o----?-oo------o----------B---------B------B-----o--|-------X-XM--E-M-----
-----------------BX----B-o-o----o-oo---?---Bo------------M-----Xo----------o---|o---oX?-----------B------oB--o-o------------B-------------T----o--------o-X-o---o-------o--o-----?|-------------T-------
------------------B-B-o-o------X--o-------E----oo-X---BXo---------------B----o-|M-E--E---o------oo-----B---o-------X--E------o--E-------o-|-o---------X-------------T-oo---?------|-B-o-----Eo--|-------
--------------o-------o-X--o----------B-o-B-E--Xo--o----oE-----o------M-----o--|--B--?-B----E---------------------E---X-o-------To--o---E-|------E--X----?----------|-o-----------XMoo---B--?--o|-------
--------------XE-------M-----o--Eo----------Xo-----------B-----M-E--o-o--o-----|------------B-o------X------------X------------?|-E-----B-|---oT-?--oM-E--------o---|----o-------o--o---B-------|------v
---------B--E--T--T------------oM-------X-------------?-E-o----o-XE--o------E-o|---oo-o--oo----o---X---T--o-o----------Xo-X-----|-?B---T--|T---|----oooM--------o-o-|-Bo-----------EEM-----o----|E-----f
------------B--|--|---o--E-o---B-Bo-oX----o--o--M-B---M-X-------B-Xo-B----o-X--|-------------o---------|--E------------------o--|--o---|--||---|o-o-E---oE---E-X-?-o|X-------------XB-------B---|X-----f
---------o----o|--|----M-X----B--------oo----o----o----o-----o--------oo------B|--------E--B-ooE-----T-|--M-------o---o--o------|------|--||---|----Bo---B-X-?------|----o-----------------M----|------f
-----------oo-o|--|-----o--o----o--o----T----------M-------M-o----Xo-o-ooX----o|-----E--X-X---EX--T--|-|---Eo-------o---E--o----|-o-M-o|--||o--|----o--------o------|-----o-----------o-----o---|------f
--o---o--X----o|-B|----o-o-X-----oo-----|--B--X------T---------oo---o----o-----|o----?-o---oo-X-B-|--|-|---B-M----o--?--X-X-----|-oo---|?o||---|-X---o-?-------o-oo-|o--M------------------o-oo-|------f
-----o---------|--|---------------------|---o--------|-----------------o-o-----|-o----------------|--|-|-----------------------o|-o----|--||---|-------o------------|o---------------o----------|------f
m-----E----E---|--|--o-o----EE-------o--|----o---o---|--EE-----E-E-----o------o|---------E-Eoo-Eo-|--|-|-o------ooo-------------|------|E-||---|--------o----oEo----|--E---EEEo-------EoE---E---|E-----X
XXXXXXX--XXXXXX|--|-XXXX-XXXXXX---XXXXXXXXX-XXXXXX-XXXXXXX--X--XXXX---XXXXXXXXXXXXXXX----XXXXXXXXXXXX|-|-X-XXXXXXXXX--XXXX----XXXXX---XXXXX|X--XXX----XXXXXX-XXX----|X-XXXXXXXXXXXXX-XXXX-XXX---XX-X-XXX
