--------------------------------------------------------------------------------------------------------------------------------------------------------------------------------------------------------
--------------------o--B-------------o-X----o---o----------Bo-----B---o-----------o----o-----o--------------------o------------------------X--------B-----o-o-----X--------X---------?---M?-------------
------------------o---o-----o---B--------o-o--------------X---o----E------B--B-------E------------M------------E----------o---B-o------------o----o---o--------o-----o--------o-----E-----?-o-----------
----------------------o-------X------M--------o----oX-------MoBo---B-----o--o--?---B-B-B----------------B-----oM-----o----X-------oB------M------o-o---------E-----oX-X----------o--B---X---?---oB------
-------------------Eo--B--o-B---------------oB-----B-------E-------------------oM-----o---------?---MMo----oo--o-----ME------E---------------o---------------X--oo-?---oM-o-o--o------oo--------o-------
-------------------X--X---B---o----o---B-------------------Mo--o--o-M----E-T-------------------o--------------o------X?X---BBB---B--BX-o------B-------o-----o--------B---------------M--------X-E-------
-----------o------X------------B---X-------B-------oo----E--X-----o---X--X-|----o--------o---X----------B-o--o----------oo-------o-----o--o-------o-o-----oB------o-----o-----E-o------X--------X-o-----
-----------o---------------oBMo--------------------B-----?o-------o-o------|--------o------o--M--Xo--B-----Mo---o-----o--------o--------o----B------o-------E-o---o-----oE--o-?--o---------------------v
-----------oX-----o-------------?------B-o----T---E-----------o-----o------|o--------------M----------o--o---o--M------o-o--o-?X------E--?--------------?---B--o---------?--X?-----o------B------oT----f
-----------------o-------B-------Bo-------o---|-o-X-X--o-------oo-EX-------|-------?------------?-----o-----o-------o---------o-oo----X----------X-----o-----T------MX-oX-----o-Mo------oX-T--oM--|----f
---------------B---X----M------o---------M----|----E-B--?-B-?-----Boo-----o|oo-----o--ET----o--Xo--o--X-----o-o----o------X----------B-o---E-BX-o-----o----o-|----------------o---E---B-o--|----o-|----f
--------o--X---M-o---o-o----E-----------------|---oB-oM----B-----oo-----o--|oBoMoo----X|-------o--------o--X------E--o--------E-----X--o-o-T------XB---X--o--|---------------X----X--M--o-X|------|----f
-------------o-----o--------B-----------------|B-----o-o--o--o-o---------o-|--Xo---o---X-o--o----o-o-----o--o-----?---Bo-----oTM---o---o---|o---oB-o----X-B--|----X---B-M---o---------o----|----B-|----f
-----o------o------------------o----------o--o|--------------o------------o|------o--o--------oo--o-----------------o---------|--o-------o-|------o----------|-----------------------------|----o-|----f
m------------o---o------------o---o-o-------oE|--o-----o-----o-----o-------|-oE-E-----o---E------o-----------E---o-E-----E----|------E-E---|----Eo---------Eo|------o--o---o----Eo-------o-|----E-|----X
X--X-XXXXXX-XX---X-XXXX-------XX-XXXXX-XXXX-XXXX-XX---XXXXX-XX-----XXXXXX-XXXXXXXXX--XX---XXXXXXXXXXX--XX-XX-XX-XXXXX-XXXXX-XX|--X-XXXXX-XXX----XXX--XXXXXXXXX--XXXXXXXX-XXX-X--XXXX--XXXXXXXXXXX-XX-XXX
