--------------------------------------------------------------------------------------------------------------------------------------------------------------------------------------------------------
----------------------o----o-------?----o-o-----------------o-----E-o-B--B-o--------oo------o-------T---X----------------o-------------------------------------------E---X---EoX---------------o--------
--------------o--B-o--------o---E---X---M---o-----B---B---o--M----M-------X---o---------------------|----o-o------ooM----X----------o--------------------------------BE------X-E-X--oo----------o-------
------------------oM---------X--X-o-----o----Mo---o-------------------o--o--o--X--------o-X---------|------o----B-o-o-----------------------------------o------------oX----B---?B----B---oo-------o-----
-------------------------o-----E------o------o----------o-----------o--X-o-o-----EB--o-------o--B--E|----?-E----------E---------?o--------------------o---o-o---------o---ooX--------o--o-------B-o-----
------------M-E-o---E---------o?---oo-oB--o----E---o----B------T----o----------o-B--B-----o---o-o--B|--o---B---o-o---ET------------------------------B---o-------X---X-B--oo-----o---o------o--o-oB-----
--------------X-----M-B--BX------o-Eo-o---M---MT-------------Eo|-----o---o-Eo---M--o-----o----------|--------oX------?|----?------o-X-o-o--o----------o-----o-----?------o-----------o-----X---X-o------
-----------Xo--o-----o-------B-o--BM--------oB-|--o----------X-|-----------Mo-----?X--o--o---?------X----o----o-------|------------o--------ooo--o--X---------o-E----o------oB--?--------E-------------v
--------oX----------o------o--o-o--------------|--M-----------o|--o------M--o--------------o------o---X-------------o-|------------o----------------o--B-----o-oB------o--o---------E-o--B-----o-------f
-----------o-----o-------o-X-o--o------o------o|-o--M----------|------------B-----E--?Xo-X---------X----------------o-|-M--o----M---oo----o-----------o---X-------B----oE--o-o-----oMo----o-M----------f
--------Bo----------X------------B-X---X--o----|---------------|------E-----------B---------Eo----------X---o-------?-X-------E-oo----------------M--oo--------o------o-B------o-o-------X--------E----f
-----?----------?--o---o--------T-------o----o-|--X-o-------?--|-----oM--o-o----o-----------?--?---o-------E--o--EE------o----To-----oB----------------oMX---T---B-E----------E-----E----------o--X----f
--o--o-B----oo------o-----o-----|---B----B-MXT-|---oo--o-T-----|o--------o---------T--o----X---o---M-------X--o--BM-----------|------T--o-----------------M--|-B---B----------T-----B---X-B------------f
-o------------------------------|------------|-|-o--o----|-----|-------------------|---------------o--------------------------|o-----|---o---------------o--o|-----o-o--------|o------o----o-o---------f
mo----------------o--E-------E-o|-o--------oo|-|oo------E|-----|-----------E-------|-oo----o------------o----o----EooE--------|------|---o-------------E-E---|--o---ooE-------|oE----------------------X
XXXXX-----X-XX--XXXXXXXXXX---XXXXXXXXX----XXXXXXXXXXXX--XXXX---|-XXXX----XXXXXX-X--|XXXXXXXXX-----XX---XXX--XXXXXXXXXX-XXXXXXXXXX----|X-XXXX--X----XX-XXXXXXXXXXXXXXXXXXXXXXXXXXXXXXXXXX-XXXXXX-----XXXX
