--------------------------------------------------------------------------------------------------------------------------------------------------------------------------------------------------------
--------------------------------B----o------o---o---------------X-----------------------------BM------o--o----------------o----------o----oo---E---------------E---X---M------------------o-----X-X-----
------------------------B---E-o---o--------X-oo---E-----------o------------------------B-----------M-MME--o----X----o-----M-X--BX-----------o--?-------B-------X----------o------------------To---------
-----------------------M---oX------o-----E--------BB---------------T----o---?-o----Bo---o------oo------Mo----------o--o--o---------------o--o----o--------------o----o--o--o------------B----|-o--------
--------------------B-------------o------X-----------o---B---------|-------------o--Bo---E-------B?------o--o------E------oB----------?-----------B---M---X-o----E-----o---X---oo----------oo|----o-----
--------------------------o-------------o---M--------?-----------o-|--o--E-------o-----o-B----B-o--------T---o-----M--M--E--oo-----------o--o--o-------o----o---oXEoo--E-E----o-M----------B-|-X--------
-----------E-------------o--BX-XB--E--?-B----o-----o-oo-----E------|--o--X--X-T--------?---M-------------|--o---oo-------B-----------------------------o----X-----M-M--BoXo------X-------o---|o--To-----
-----------M?---------B--------o-BoTMo-?------o---o---E--o--X--oo--X-o-Bo----X|o---BX----oo-------M--?---|------E---oo----------E----------Eo-----------------o------E----oo-------------B--M|T--|B----v
----------o---o-M----E----o------o-|--o-----X------o-EM-------------o?o----E--|------o--M-B-----o-oo-X-?-|------XT-X-o----------Mo---B--o--T-----------------------?-BB--o-Mo-oo-o-------o--o||--|-----f
----------M-------M--X--B---oE-o---|-o-----M--o-----EB-o--o-----B-E--------X--|-Eo-----X----B-------o-B--|oMoo---|--T-o----o------o----o--o|--TB-------------TE---------o-----o-oMo-o--------||--|-----f
----------o-o--o-----o-----E-M-o-Eo|-o-----------X--B-o--o-----oo-B?-----XE---X-B-T-----o------To--------|-------|--|-------B-M-----o------|--|---o------B---|?----------o----X-------o------||--|T----f
--------M-o-o-B----o-E-o-o-X--o-oMo|ooo-o--oBo--------X-----oX---o--------X-------|BB-----o----|----E--oX|------XXo-|-o---B--?---o--o------|--|---o----------|---------o------------------o--||-T||----f
---------Bo-o--o----BX-o-------B---|-----------M-----o-----oT-----------o----o-Mo-|---B--o-----|----B----|----o-----|----B------o-B------X-X--|----?------o--|--------------------o--o----o--||o|||----f
--o--oo---o--o-----o---o----o------|---------------------o--|----o----------------|------------|---------|-o---o----|--------oo---oo-o--------|-----------o--|---------o-----o--------o--o---||-|||----f
mE--------E----o------o-o---E--E---|-o----o--o---E-o--------|o---------oEE--oo-o-E|--o---o-----|-E-o-o---|oo-o---E-o|-o-------oo--o---o-o-----|-----------o--|--Eoo---------E------Eo------o-||-|||----X
XXXXXXXXXXXXXXXXXXXXXXXXXXXXXX-X---|XXXXXXXXXX-X-X-X----XXXX|XXXXX--XXXXXXXXXXXXXXXXXX---X-----|XX-X-XXX-XXXXXXXXXXXXXX---XXXXXXXXXXXXXXXXXXXXX-------XX-XXXXXXXXXXXXXXXX-XXXX-----XXXXXXXXXXXX-|||XXXXX
