--------------------------------------------------------------------------------------------------------------------------------------------------------------------------------------------------------
-------------------------------------o----o----o----M-B----o-o-----------B-------------?B-o-----------o---------X-EX---------------o-----?B-M-BX----------------o----E--o-Bo-----------o-E-o------------
--------------X----o-------o--B-T------------E--B-E-----------------o--------E--o----------X----------E-----B-----X------------------o--X---------------------oM-----B------------o----o-M-o------------
-------------o---------Bo-------|-------X-MB-X----M------o-----o-------o-----X----o--XBE--o------X-E--X--o----o-Eo--------------o-E---E----o--------E---------------Bo-----------X-----EE-T---BXo-o-----
------------o--oE---X----X----oB|----o--o-------------T---oo--o--E-----------o---------X--------?--M---?--Mo---oBBo-------E-------X---X--o---B------X--E-EB------B---o--B-E-----E-o--ooMT-|o-X---o------
--------------M-X---------------|o---Bo--------X----B-|--B--o-o--X------B-------o---X---o---------B---o----------oo----o--X---oX-----B-----oXo--o-o----T-B----E--o-M-B----B-o---M--M--o-|-|X---EE-?-----
--------o--Mo--o-------X---o----|--------o-------X-?-o|----o--X-----X------o-----B------T--E------o--oE-o------M---ooBo-----o-----o---------o----------|---E--X-----M---o--T--To--M-o---|-|----BM-------
---------?-----------?--o-o---B-|---M---------Eo------|-o------o-----------E--o---o-----|o-X---o-E---oM-B----------o-o--o----------B-----o------B--o-o-|?oMX--oo--------BE-|--|--X------|-|-----o------v
-------------o------X-M---Bo----|---?-o------XB--oB--M|------o-B-------o---B------------|-----BoEB----------B----------Xo-X-E-M-o----M---B-----o-------|--------------o--?B|B-|-o---X-o-|-|---X-o------f
------Mo----o--------oo--ooM-o--|-B--------------o---o|-o--------------X-------o----M---|--oB-o-X----------o-------B-X------M-o-------------E-o------M-X-o------X---X--o---|--|o--------|-|-----B------f
----Bo--o-----T-Eo-----o--XoXE-o|o--o--------o------TE|---Xo-------?----------E-------o-|---------------------o---o--------?-----o-o-o-----oB---------------------oo-------|--|Xo-Xo-B-X|-X-----o-B----f
----------oB--|-?--X-Eo--o---M--|---X-----o--------B|X|---------o--o---o-----BXB-----oo-|----------------o-----o-MB-o----------M-?--o?---------E-?o-----oo-------o--o------|ME|---------|--M-----o-----f
--oB----------|M-----M----------|-o-------oo------X-|o|---------oo------------o----B--oo|----o------B-------------oo-M--M---o---------X------T-M----o---o--------M---X-----|-X|-o-------|--------B-----f
-----------o--|----o-----------o|o---------o--------|o|------oo--o---------------o------|--------o----o-----o------------o------------o---o-o|---------------o-------------|--|-o-oo----|--------------f
m--------o----|---o---E-EEo-----|----------o--------|-|--EE-------E--Eoooo----o-----E-oo|-o---o--E-----o--------oE--------o---E-o------------|----------o---E------oE-o-E--|--|o------E-|---o--oo-o----X
X--XX----XXXXXXXXXXX--XXXXXXXXXX|X-XX-X----XXXXXX---|XXXXXXXXXXX-XXXXXXXXXX--XXXXXXXXXXXXXXXXXXXXXX-X-XXXXXXXXXXXXX---XXXXXXXXXXXXXXXXX--XXXXXXX-----XXXXXXXXXX-XXXXXXXXXXX|-XXXXXXXXXXXXXXXXXXXXXXXXXXX
