--------------------------------------------------------------------------------------------------------------------------------------------------------------------------------------------------------
--------------------O--O--------------O---------------------------MEE-------M--?-------B-B-------XO-------------O--------O---BBX-----O--------E----------M---EB--------B--O-----O------B----------B-----
--------------------OB-OO----M-O-O-----O-----O---T-------B-B-O-----?M-B---X-O-B-----------B------O---------BE----E--------MB--------X---------M-M----O-------M-------O------------M-------OO------------
-------------------------OO-O-O-O---TT--------O-O|------------OX?O---O-OX--O---E-T--B-B--------OO-----------XO---M-----------------O----O---O--O----O------O-O------E---O--------O--O--------O---O------
--------------------O--O------------||------BO---|X----T-------O---E-----E-----XO|----O-------?-------------------?O---------OE--O----------?--------TO---O------O--ME-O--O-----------O----O---M--------
--------O----O---B-------E--T---?---||--------B-O|-----|-----BB----T---O-M-?--M--|------O---O----------OO-B-------OO----X-----X-X------------------O-|?--O------O---O?OO-X-OO-----BO----O--T-----M------
-------------E-------O---X--|-O----O||-------O---M--B--|O--O------X|--------B----|E-----OX--O-----OOO--XOO----------------O------B------------E--X---|-O-B----------O---O--?---------------|-B--O-------
---------O--E?-------O------|--MOOO-||-B--------O--O--O|E-----O-M-O|------------B|B---E----X-----O-------?---O----------O-T----O---------?----B-----EB--E--------B----OO-------E---X-------|----M-B----v
-----X----T-M-----O-BM----B-|-----O-||O-M----XB-----O--|B------BO--|--O------O---|--OOM---------B----O--TX----------------|----B---T---O-O--------O-B--?M--O--O-M--E-----O--O?-X?----------|------O----f
----------|B-------BO-O-E-O-|--O---O||-O-----O-----O---|---O-----E-|X--O-----E---|-----X--O---O---------|--X--E-----O-B---|OOO-O--O|--O-----E-----M----------MO----B-------O---------------|-----------f
---O------|-O-------E--OB---|----B-O||-----OX----------B--O---O--M-|-B-MT-OT-M---BX--------------ME-O---|-----X-O-?--B----|--O-----|E-O-----B------OO-------O-------BO---------O----O------|O----X-----f
---B?-----|---TO-O--MO------T-------||-------E---BOM-X---B--O------|O-E-|--|-O-----X-----B-----X--T-----|--E-O--X--O---O--|--O-----|BM-OO-B--------XO--O------OXB-X-----------X-MB--M-----O|--O---O----f
--M-O---X-|---|----O---O-BO-|-------||-------X-------------X---OO--|--X-|--|O-O--O-O------O-------|X----|--X--O--M-X-O----|M-------|---X-XO---M------BXO----------O--------B-O---O--OT-----|---O-------f
----------|---|-------------|---o---||-----------------------------|----|--|-----o------o--------o|o-o--|---------o----o--|--------|-----------------o--o---o-oo-----oo-------------o|-----|----o------f
mo--E-o--o|--o|-----o--Eo---|EoE----||---o-----o-----oE-----------o|oo--|--|-----o---Eo--o-o-----o|---o-|--------E-E---o--|--------|----o---E------o---EE-o-o-Eo--EE--E--E--------E--|---o-|-Eo---------
XXXXXXXXXXXXXXXXXXXXXXXXXX-XXXXXXXXXXX--XX-----XXXXXXXXXX-------XXXXXXXXXXXXX--XXXXXXXXXXXXXX----XXXXXXXX----XXXXXXXXXXXXXXXX---XXX|---XXXXXXXXXXXXXXXXXXXXXX-XXXXXXXXX--XX-----XXXXXXXXXXXXXXXXX---XXXX
