---O---OO--------O---OO--------OOO---E---O--O-OO-OO-O--O----O-----------O-O---O------E-O----O----OO---O-OE--O----O--EOO-O--E-O--EO--O--O--OOO------OOO-O--O-O--O-----O--O-----OO-E----OO-----O---O--OO--
-----O----OOO--T-O-O-M--XEEOOOT-O----X?--M----O?OO-----OBO---MEO-----------X-?-------XEB--OB---O-OXOO--OOX-OOE-----XX-O-M-B?BOO-MB-MTO----O-?O----OOE-M--B-X------M-XOMB-E-X--O-EMO--X---B-OO-T--OO-O-MO
---O--O-----E--|-OME-----XBXOB|XOO-O---E-O----B-OO----EOOE-O--B---BOM--O-E-OB-M--OOO-OBOOO----XOEO-MO--OO-?O-BOO-MO--O-B-E----BXO-O-|OO--O----OOX-OOX------O--?XBO-----O-B-O-OXOTO-M-O---OB---|X--BOOB--
-O------OO-O?OE|?O-X--XX-O--O-|-E-T-XOOXO-MT---OB-O-?-XO-MOEO-OOO----E---?E------BTMMOE-BXB-XO--?---OB-O--OO-O-MX-O---X--B-----O---O|O--E--BO-B-OO-BB--O--E---OOO-O--EO-O-MOO--X|E-OO-----OX-M|O---M?---
-------OBOO-O-B|-OOOE-OOXO-O-O|OX-|OOE-OB-O|EB-B--OE--OO-X-TO--TBOOO-XXEMOBM-OO---|O--XO-OO?--OX--OOO-O-OO--B-?---OO-O-OMOO----O-OBB|-OOMOO-EX----M----MMEB-BO-O-EM--XOO-O--XO--|X---OX-OOOO--XO-OOOO--X
---OOO---BMO-O-|OO--BOO-O-B-OE|-OX|OOX--O-O|MOX--O-B-O--O-O|O-?|---BXOOBOO--O-M?B-|-XX----O---OO--EO--OOX--OOOO--BOMOMOBO-O--XMBO-O-|--M-XB-B-E--OO--OE-OB-BO-O-OB-O-OO-XMEM-MXO|-OB--B-O-OOO-OO-X---OT-
-------M-------|TB-OO-MEOO--MB|BOE|OOOBE--O|------X--B-X-O?|BOOX-MO--OEO-O--?BOOO-|EO-E---OOO--XOEB------M-OOO--E---OOO-OOEX--OOOXO-XOX-O-M---X----MO-M-OO-O--O-OO-----MOO?-O-O?|-T--B---O-O---BMO---BB-
--OOO--O---OBEO||-X-OOOX-E--O-|-OXXO---BTBM|---O------E----|------OOO-B---E--X---O|BOOM--XB-BB--OXO--OOOO-OOO-O-BO--X--XOBB--OEO-O-O-O-OOEO--O-MMOO--OO-OO-O----O--BX-O---O-----|E|OTOOTX---O-OOOOO-O-Ov
----OBX-MO-M-X-||--TOBE-OXB-OB|-O-O--O--|O-|OO-OXT--T-B--XOM-OBO---M-OOOOOTM--TOOX?OO--XOOOX--MOO-OM--EO-OOMO-O---OX-B--OOOEX-BXBOM--O--MX-B-MEOOE---O--OB-EO--BOO----BOO--E-B?-|?|B|-E|OO--OO--EB-OOO--
--O-OOO--OO-O-B||--|X-?----XOOBOEO-OO--O|-O|XMT--|XO|OO---?--XO-----O--OXB|---|OMO-O-OO-B-O-O-OMO---M-B--MO-OXO-OO---OM-OO-B-E-O-O--?M---OO---B-OBXBO-OBX--?-XOBX-E--B-BXMO?-O-E|-|O|-X|--O-OEO-BOO--O-X
---O---M-OOO-OO||-O|-E-OO----OOTBOO-----B-O|--|-O|E-|EOOB---O---BX-OO--O-O|-E-|--OO--OX--O-O-T---TXOXOO-B-OOO-OMOB--OM----O-EMO-OOO-OO-O-OE-OEOOO-O-XO---O-O--BO--MXO--OOO-OTO-B|O|-BM-|---O-XTEO--X----
-OOO-O--BXE-EX-M|O-|OM----O----|---O--OOOM-|--|ET|XO|XOOOMOEBO-E---O-X-XOO|-TO|-O-OOX---O?O-?|-BO|-?--OO---M-E-O-O-B-O--T-EEMO?--MBO-OEXOO?BO?-EO-OO-M-M--OOOOOO-B--BO------|M-OBE|XO-E|---X--|M---OXX--
--X-XOM---T-MOO-XMO?M--OOX-T---|-?B--X-O-OOMO-|B|M--MOMT-O-MO--BO-TB--MO-O|?|BBTBO--X-O-O---O|OOOXO------XOO-XO-O-O--OOB|BBMO---XO-T-OM-O--OO-M?OM--O-M-T-O-BTOOXOOOO-XMB?OO|-BO-XB--OB|--X-TO|?MM---OMX
------o---|----------o-----|-o-|------oo-oo---|-|---o--|------o---|--o----|-|-o|---------o---|--------------------------|----------|--------------------|o---|--------------|-oo-------|----|-|---o-----
m-----EEE-|--------oo---o-o|-o-|-----o---o----|-|----oE|E-oo-oo--o|-oo----|-|-E|---------oE--|--------------------------|o---------|----------------E---|----|---------o----|oo-o--o---|----|o|-------o-
XX----XXX-|-------XXXXXXXXXXXX-|----XXXXXXX---|-|---XXXXX-XXXXXXXXXXXXX---|-XXX|---------XXX-|--------------------------|XX--------|------X---------XXXXXX---|---------X---XXXXXXXXX---|----|XXXXXXXXXX--------
