--------------------------------------------------------------------------------------------------------------------------------------------------------------------------------------------------------
-----------------oo-M----------ME----X-----------------o-o-----o-------E---------Mo?-B----B--o-----M--o-o-------X---------o--------B-----o---------------------------B-o--------X-?----Xo---------------
------------------X--o------o---T-o------X-o--o--o--oo--oo--o-------Bo-?X--o----E-?------------------M-------------?----XB-------E--o---oM----------oo--------MBo---o--B-----ooE--o------oo-------------
----------------o----X------M---|--B--------?------o----o------------X----------?ooX----Xo----o--B-------o----?--o--------o-o--X-Mo----M-----------oo--o----------o-------E----X---B------X-------------
---------oB-----EE-M-o-o-B------|-----o-X-------M-oM----M---o--Eo-----X-------X---------o--M-----o--------------------X-----o-B------o-----B-oE------------------o-B------X-o-oo-X---X---o-o---?--------
--------------o-MX-------o-B---oB----------M-ooE--------------o?o------M-o-M-o-o--X---E-------------?o--o---------o------B------o--TBX--------B----------------o--X----B-------o------X-----------------
-------------------------------o------------B--BE--oo--T-o-------o-----o-Bo----oo-----B-----------T-----o------X---o------B--Bo----|---o-------o----------M-----X--oo-------?--o--------o---------------
--------o-B-o-X----o-o--Bo----M--X-E-------o----X----oo|--o---B-B----X------oo--------------------|-----------------o-o-o---o---o--|--o--------------------MBX-o---o-----X----------o----o-------oo----v
------B--o--?---oE--oX-o-------X---B--o----o--X--------|BoB---oB-o--?-M---?----E----------X-------|--o-?-E--------MoB---------o--B-|----------------o--E-------------oM--o----o----o--------X----------f
---------X-------B----------o--oo----E-------B---------|-o--------------o-----EB--EE---ooo--o-----|------Bo--------o----o-o--------|--E----o---E---X---To-----M---------------ooo-------?----X-o-------f
-------o----oE------E-o-o-----------oX-----------B-----|----o--o--------o--?--M---?B--------X----o|o-B------------------X-B--o----o|--X--------M-------|---?B--------o------------E-------o------------f
------------BB-B----T----Xo--T-o-BE-B--ooMB----o----o--|-----Mo----o--E--------------X----B-----BX|o-------o--------------o-o------|-o-T--o------------|----------oE--?-----------B---------o-E--------f
---To-------------X-|--B-----|-Mo-X---?oB------oo-M----|o---------T--oB-----X------o-------?---Xo-|Mo----M-o--o--oM----?--o-o--o---|-o-|------T-----B--|-----------B---o-----?------oo--o-----MoB------f
---|--------oo------|--------|--------o--o----oo-------|----------|------o------------------------|------------o-o-o---------------|--o|o-o---|--------|---------o-----------------------o--o-o-o------f
m--|--------EE---Eo-|----o---|E----------E----E-o--E---|---------E|-E--o---EE-------------o----o--|------o----o--------------------|o--|--o---|--------|--E------o------------EE--------o---E--oEoE----X
X--|--------XX--XXX-|XXXXXXXXXXX-----XXXXXXXXXXXXXXXX--|X-----XXXXXXX-XXXXXXXX---XX----XXXXXXXXXXXXXXXXXXX----XXXXXXXXXXX----XXXX--|XXX|XXXXXX|XXXX---XXXXXXX-X--XXXXXXX---XXXXXX-------XXXXXXXXXXXXXXXX
