--------------------------------------------------------------------------------------------------------------------------------------------------------------------------------------------------------
-------------------OO---EO-----X-X---T--XOEXOB-OOO-OTEBE--B-B-BOX-O--OB-X--B--MM-OXO----O-OOO-B--O--O-O----E-O---OO-OOB-E-EOOEOE--BM-O-OOMO----B--E--OOE?BBBO-M--OO--OMT--O-O-O---M-----B-M---OBX-------
-----------OMB--B-?------?---OMO-O-----O--X---?E-OOB|EOBOX--EOEO--X---BE----XOEOEO?EOO-O-T|-OXOO---TOB-----O--O---OB-O-OMOXOOMEOMOE-OOE--O-ME-O-X---BO-OO--OMM-OMO--O---OB------BOO-O-X--------O-OO-----
-----------------XBO------E--M-OOO---OEOOEO---BOT-O-|BBEEO-OEOMOOTE-O-O|-----MO-O?-MO-O?-TEOBOOBMOBM--|OXX--BE|OOOOEOO-O-MXOBOMOO-OOOBEO-EBEE-O-OOO-OO-O-E-OE??-E-OEOBOE-O--O-OEO----O----OE--B--O------
-----------B----O-OOOO--XB---------OB-BO-MEEE-O-|--XBOMOXOOO-O--E|--OEO-E-O-O--OBB-O-X-XX|OO-|-B-X-E---O--|EXMEOEOOOBEEXO--OOEOBXO|OO-OBO|-XMEOEEOO-O|OOOBOOOOO-E-XBX--?O-O-?X-X-O-?-----EO|-EO-O?------
------------BO-O--O--B---?----XT-O-B-MOOBOTOM-OO|-O-BOBXMOE-B-OB-XE?-OEOM-----EO--OEEOEO-|-OEBM-O-B|XE----OBO-OXXEOOM?----BOO|OOT-EO--OOEMOOE--|E-X-|-BOOOTTXE-BM-O-O----OOM---OE-M-O-|O-O--BX----------
--------OEO-----O-E--XO--O--O--X?EBEXM--OO|EOOBOT-OMOO-O-MEE---EEE-OXEXE-MOB-OOOO-E-TEO-E-EMO--OMO-|OT---O----XO-BOO-O-MX-E-EBOOOOX-OB-OOT-OO-O|---T|------EO|EOOOO-E-OO-B-OEOO-BO-OO-E--O-T-OO--B------
-------O-O-E-X-E--O-XOO---------MBO----E-E-?O?-OOBEOOOOE-XBOOXO-X-OEBO-XTOOE-X-BT?|-|OTEXE---O-OM--|E--EB-|----E-XOEOEOB?OBBBEOBME-EOOOOOEM-O-EOO--||OOE-O||TOXOEEO---O--OO-BO-B--OOO-TE-|-|-OXXBOO----v
--------OT-X--EO-----T----B--O-OOOOO--MMOBMOO-XB|BOOE|EX-OB|EB---M-XB-OX-O|BOO-E-OE-X-|BOME-EEX--M?-OO-X--O-O-OOOOOEEXXOOO-EOXXOO|EBO--MBB-MOEB|--OE|--M-O|E||-MBOOE--B-E--OO-O--OO----T-EO|-O--OEO-----
------EO|--OBX-?-O-O----B-O--||----|-EEB--XEO-XOOO?|TO|OE|-EEOM-|EO-OO-E--OMO-EEO-|O-O|X-O-BT|OXO--|-|--O---MOOEMEO-BE-EOBE-OX-|EXOOEOEXBO---OE-OE--E-OOOO|||EO-O-|-EO--XXE-|OTEXBM---|--|EXEO----O-----
------------OOO-OO---O---O-X-O---OO--OB-O--X-EOO|O--EOXOBE?MB--?OX|O--E-OO|-BE--|XO-O-|-----E|----O--|-OT--OE--XEEOOOO-OX-BEMMOEXO-OOBX-XEOO-EO|OM-?|-OOO-|O|?OOO-EOOE-E-EXEO-|-|--OEE||OEM-T-OT--E-----
---E---E-|-OB-EEXO-------------XO-X--|OOOXE-BEETOOXO|OOOO-OE-XEOO-||OOBO?|E-B-|-OOE|B-|-M-O-E|OE|OO|?-BT----B?OOTMO-EEOO--EBOOO?EEO-OE-EOBE-OO---OOBE-?O-O|||EE--EEO-|BM-X-BX?-E|-O-X|E|B|B-O--|--B-----
---BOBMB--|O--|O---|B---X------|--TXMOOM|---O|?|OOOB|OOX|-E?OM--M?E-OOOMB-OOOM-OTO-EMOB?BOOB|--O--TE-|----------O-O??XXE-OOOOEOOXT-OOBOOTOO---XMX-X-MO-EX-|OEX?-X?OMTEB?B---O|E----OOO|--E-O|X--BO------
---o-----------------------------||-o---|o--o|-|||-o|o-----||-|-----------|---|-|-||-|-|-----|----oo--o------o--|o-o---|-o--||---o----|-|-----------||-|--o||-------o|-----oo||------|||-|o-|-----------
m--o---------oo--|--------|------||-----|----|-|||---o-------Eo-|--o--|o--E---||-----oo--|E-|--------|---------oE--o-----|-||----|----|-|-|--|----o-|-o----|o------E||---o---|o-------o|o|--|--|--------
X---X----X---------X--X-X--XX-----|-|----X-----|-----X-----X--|--------X--------|---X----------------X--X-|-----------------------------|-|-----------X---|---------|---X---X|XX-X--XX---XX-|--X------X----
