---------O-OO-O--------EE---O-------O-O-O----------------------OO--O--OE-OO--OOEO-O--O-O-EO---O--O-O--O-O-EE--O--E-O--OO--O----O--O-E-O-OO-EO--O-O-O--O----O----O-O-OOO--OOO--O--OE-----O--O------OO--O-
----OO--O---O--O-O----OMB-BO-?---BO--O-OBOOO?O-OOB--O-OMOOM-E---OEOM-?-B---EOOOT-XO--X---T-OO-T-OXO?--M-XOM?--B-O?M-T?E?-E-----B---BB-?--O-B--O?--E---?O-EO-XXOOOBX-EO-EO--OOOO-E-MO-OB--OXEB-O--E-OEOM-
--O--O----O-O--------B---O--OOOO---X-XOOOOOOMOOO-----T-OO-O-X-EOOTO-OO--OOO?BB-|O-?O--O--|O-O-|-OOO------O--OE-O--O-|-B-E?XO--------OO--X----O-OOXTOOOO?OM--O-------B-OBTM-MBTOMM--MO-OOXO-MO----MXOMOBO
-OOOOOOO-O--TMBT--OBO--OEO-XO--E--X------B-EO-X-MO---|---X-XO-MXO|OOOXOEBMOOE-O|M---M-MEO|O-?O|BE--OX--X-E-OEX-BOE-O|---B---O--OEB-OOOO-----------|OX--OO--E----OO--OO--|-O-O|-O-XO---OO-B---X---O-OO--O
----O-OO--OO|O-|OXBOO---BXO-X-OB-O-OT--O--OXO-OO-?O-O|OE--O-O----|XEM-OX-OO-B-X|ME--O?-?X|OO-X|OB-B?-X-OBXE-?----XXE|B-MOOO--OOBX--OOB-X--EEO--O--|X-OOO-OOB--XO?B------|OX-O|OOOOE--XOM-OBE--MT----OEEB
-OO----O--O-|-O|T----OXE--E---MO-O-M|OM-TE--B?-X-O-XO|TME-BOE-E-O|OX--O-OO-OO--|-X---B-OO|-X--|OOB-O--O-O-T-OO-OO-OM|-O-O-B-EOXO--X-OOO--BMMMM-X-B|-OOO--O-X-X-M-OXOX?XB|----|X---XET--O-O-BOE-|E-OOOXX-
--O-----O-XO|OT||B--?O-BO-X-OO--O-T-X-O-|XO-O---BO-O-|X-XX--B-X-O|E-OBOOX?O-OBE|------T--|O-OOB-OOOO--B---|-OB-XEO-OTOO--MO-MO--OO---?O-O-O-O--OO-|O-?O---O-OOO-OO--O---|--O-|-----M|O--XXOO-T-|BXXOB---
---O---OOOOOB-|||OBO---O--O-XOOX-O|-O---|--O---E--O-?|-EOOEOOT--E|M--XO---O-T-M|O--OOO|-O|-O---OOO-OTO---M|---BEX--O|O-----TO-O-M-BXO-OOX-OOO--O-O|O--OOOO---OBO----O---|X-O-|-XO---|BB--OO--|O|-OOO---v
--O--O--EE-B-X|||OOOO--OOO-XOOOOOB|XO-XXX-B-BO-X-?OXB|-XOOBO-|-TX|-O--?---E-|O-|O--OBO|BM|E--O-?---M|-OO--|OOOO?--MO|O--?--|--O-OX--?---O--M-BMO--B-O-X-B-XOO---MT-?-B--B-O-TMOEOO--?--OOO-O-|-|O-E--OOO
-O------BM--OOXX|--OX-OM--O--O-EM-|-XOO--B-X-O-OBO---|-OOOO?X|O|OB-O-OO--O?O|B-|-?B-O-TOO|B-BM---TX-|-M---|OM---OBO-|-X--XO|BOEXO-----X-E?--OOTOO--OX------EBB---|O--OM--O-O|-XBO-O----O-E-OMB-M-XBOM---
-----OO-O--OO---|-BOX-----OO---B--B-O-O-OO-OOOO-OOO-O|---OO--|-|-O-O-O-O?-O-|O-|--OO-X|--|-O----O|O-MO-OX-|-O--OX---|X-?-O-|O-T-OO-----EB-----M-XO-M--O?-EO?OO-OO|B---OXO?O-|-OO------?BOBE-O-X--O-OO--E
-O-O-O-OX-?BMOOO|--BOOB-EOO-O--OEX-M-BOO-O----B-O--XO|E--O---|-|--BBOOXOO-E-|OOT--OXO-|OO|OBO--OO|---B---?B?EOXO-BO-|O---XOBOO|-BO--BO-XOEOO---OOE-OOX-OXBBEEOEB-BOEXOO-EO?-|O--OO-O-TO-MOBE-EO-OB-O-OOM
-----B---OOO-O-B|TO--O-OX-M-XMBOM-O-B-O---BO-O----BO-|MM-O---|X|??OOT--O-BXMBXO|?XXOO-|--|--B-O--BOBO--OO--OB-O-O-O-|OT---O--O|MO--B---O-MO?BB-?-BM-M-OO---TXO?OT-OM-OX-?--B?OTBX?XXX|--O--MOXOOOOMOB-OO
-o----------o-o-||o-------------o----------o---oo----|-------|-|----|-------oo-|---ooo|o-|--------o--o--------------|-|o-----o|---o-o-----o----------------|----|----o--------|--o-oo|-------------o----
mo-----------o--||-o---------o-o----------oo---oo----|-------|-|----|------o-o-|-----E|o-|--------E-ooo-------------|o|---E-Eo|oEoE-o-----o-------------Eo-|----|---o---------|--ooo-|Eo----------ooo---
XX---------XXXXXXXXX---------XXXX--------XXXX-XXXX---XXX-----|-|----|---XXXXXX-|X--XXXXX-|--------XXXXXXX-----------XXXXXXXXXXXXXXXXX-----X---X--------XXXX|----|---XX--------|XXXXXXXXXXXXX------XXX---------
