--------------------------------------------------------------------------------------------------------------------------------------------------------------------------------------------------------
----------------------M-B-------T------O----------------------------B--X-X--------O------E--O----------------B----------B------------------O----X--O--------M-M----O--O-O-----------?---------O-O?------
-------------------O--O---O-----|------------------B-----------O---------O--O----------O-?--O----------O------?O----O---O-----O---?---E-B---O--------?---O----OB-----B---OOX---------O-----O----OOO-----
----------O-X------O------E---O-|OOO--B----E-O---O--------------------XO------------O--B--X-----------M-O----O-----X-------O--------O-B-------O-O--E--O--O--E--------O---T-------O---------OE-O---------
--------------B-O---M-OBO-XB----|M--------B?--T-O-O-O------B------O------------M--------OO-O---O--E------O----OEB---O------------------B--X-----T--M-----B--X---O-------O|--B-----------XMB-BX-BX-------
--------B---------X-------O--O--|------------O|OM--O-------O------OX--O---------X-------O--O---M--T--BOX---O-O-T---------------O--------------B-|T?--B-E---O-O----B--?-O-|------X----OO--O----OO--------
---------------O---------X---O--|----MO-M----O|--BX----------O-O-O------O----O----B-O---------O---|------------|---------------M---E------O-----||-----B--O---BO---------|---O----------------O---------
--------------O--E---OB-----X---|------XO---B-|---O--?--O-O-O---O------------------E----E---------|O-OO-------E|---------E---------X------------||O---------OO-----------|-O---------------O-----------v
------B---M---O?-M-M-X------O-XTM---O-----O---|-----O----O---------E--O--BO--------B-O--X---B----O|-----O-----XX--------OM--O----E--------------||----O-OE---------------|-------O-O-O----E------------f
-----------------O------O------|--O---------E-X---O-O-----------O--X-E?------------------O----OEO-|------X-------------B--E------?-----E---OTB--||------MX----X--O----OOO|-----X-----T---OB--OO---O----f
------X-------M----O?-O--M-----|-----------OX----------O--------T----?--M----------------------X--|B-X------OM------O-----M-?--------M-T-O--|O--||---------O---O-O-------|---------E-|--X--O-O-E-------f
---O-O-?X-------OO----T---OB-M-|-----------X--EOO--O-------O-O--|B---O----O--M--M--OO-----------O-|---O---M-O------X-O--M----X----O---O|-B--|E--||---O---O-?----B-E----T-|--------EX-|-E---O-M-B-------f
--B-BOO-----O---------|--------|-----O---O--O-B---O-B---M-----O-|------------O-O---O-------M------|-----M-----------O-----------X------|----|X--||-O-------OX-O---B----|-|O----BB-T--|-B--O---M-O------f
----------------------|------o-|----------------------o-o-----o-|o--------------------------------|----o---------oo-oo-o---------oo----|----|---||---o--------o-oo----o|-|----o---|o-|-----o-----------f
m-EE--------------o---|-o-E-E--|------------------o-----o-------|-Eo---------oo-oo---E------------|----o-----ooo-------------o--oo---o-|-E--|---||------o----o---E---E-|-|--------|--|--o---oo--o-E-----
XXXX-----XX-----XXXXXXXXXXXXXXXXX--XXXX---------XXX---XXX-----XXXXXX----XXXXXXXXXXXXXXXXXXXXXXXX--|---XX----XXXXXXXXXXXXXXXXXXXXXXXXXXXXXXXXXXXXXX--XXXXXX---XXXXXXXXXXXXXXX--XXXXXX-|-XXXXXXXXXXXXXXXXX
