--------------------------------------------------------------------------------------------------------------------------------------------------------------------------------------------------------
---------------o------oo---B--oX--o---------------E--o--------X---X-----o--------------------X--o---o-B-----X-X------------------o-----------o---Bo----o------B---o-----?--X-------------M?-------------
-----------------M-o-------E-B----o---B-X--Xo--o--T-o----B-----E---XE-o--E---o--------------E-----------BX-o----o---Bo--X-----Xo----------o------o------o-------o-E?-----o----o-----E-----?-o-----------
---------------------E--E--Mo----o-----E-X----o---|XB----o--o--X---MX-o--?-B-o----------o--o?o---------o---------o-----X--E-B-------------------------------o-----B-XoX----------o--B-E-X---?---oB------
---------------M-----B--T----o------M--T---E----E-|--o-----o---o-----------------o-o-M--E--o----o---o--?oo-------o--------M---oo----------X---o-M---?-----X-E-X--o------M---o--o-----oBo--------o-------
----------X--B------o--o|---B?-MBB---o-|---?----BT|------BB--oB-E-----o-B---E------T--E-Xo---X-o-B--o------o---o-----X----oM---------------------B----oo----X---X--------------------o--------X-E-------
------------------o--o--|----------o---|Xoo------||--o--------o-X--o-----o-BXo---?-|-oX--E--B-------B---B----------B--M--E-----oM--------XooXBoo-o--oBo----B-------X-----E----E-o-B----X--------X-o-----
-----------?-o--o-----o-|-?-------o----|-M-o---oo||-o--o---o-----Mo------o---o-----|-o---M----E-oo-o-o----o--------o-----?---o----X-----------------Eo--------ooo--------B--o-?------X-----------------v
----------------------E-|--E------o----|o--------||o-o---oX-----------B------------|--------ooX--?-X--B----E-o--B----------o-XT-------o-------------M---X---o-----------o---X------o------B------oT----f
-----o--E-M--o---B----X-|--B--------o--|---M-----||----------B-------o-------------|-o----Xo---E-------o---M----------------o-|-------------o------o-----------B----ME-------oo-M-------oX-T--oM--|----f
-----T--B---------------|o-----E---o?--|-----o---||---o--o-BX---------oo----------B|M-----o-B--B---o--o-----Bo--------o?------|------------o-------B--o----o-X-------?---E---Mo--E------o--|----o-|----f
-----|----E--M-X--E---o-|-----oB---o---|TM-o---o-|M------o-o-o-----oo--------------|-o-X-o---ooo-o----E------T-o----------Mo--Bo-E----o---------------X---?--------------X-------T----E-o-X|------|----f
-----|-o--X---o--BXo-o-B|------------o-||------?oM-B-BM-o---o-M-o------TB---o-o----|-------------Bo---X--X---|--------o----------B--o--BB-T--------------------o------BB----o----|----B----|----B-|----f
--o--|-------------o----|--------------||---o-------------------o------|--------o--|-------------------------|-o----o-o------------------o|--------o-o--o---o---o------o---------|---------|----o-|----f
mEE--|-o-E---E-----E----|oo------------||---------E----o--o------------|-----o-----|---o--o----------o-o-EoE-|---------o----o---EE--------|---o----E---o---E-oo---oooE----Eo----E|-------o-|----E-|----X
XXXXX|XXXXXXXX--XXXXXXXXXXXXX--------XXX|X-XX----XXX-XXXXXXXX---XXXX---|X-X-XXXXX-XXX--X--XXX-----XXXX-XXXXXXX-XX---X-XXXX--XX--XXXXXXXXXXXXXXX-XXXXXXXXXXXXXXXXXX-XXXXXX-XX----XXXX-X-XXXXXXXXXX-XX-XXX
