--------------------------------------------------------------------------------------------------------------------------------------------------------------------------------------------------------
-----------------OO-M---ME--O------------M--------------------M--X---E-----B----O---------------E--B----------------O------------O-O--O-------------O-----------O--------------------------------OO-----
---------------E-----E---M---------M-O---------O--O-X-XO------OB----E?----O-T----------M-XO-----X--------X----M----M-?O---------EO----MO--BO----OE-----------?-O--TOO-O--E-------E-M--MO-T--------------
---------------B-E---BO----OM----O------------TB--------------------X-O----O|------O--------M----B-----------O-M--------------O-?X-O------O-----BB----------------|---X--XO---O--B-O---M-|-O----O-------
-----------------B-----M--O---------B--BO-----|--T---X-----T------T----O--O-|--M---OBE---O-----O--E--------E-M----B-OO---O-OM--X-----?----------O-O---O--O---X----|------------------O--O|OOXB-B--E-----
------------B----------O-B-B-------O-----O--E-|-?|-E-O-----|-----O|--O---X--|------M-X--O-B---O---?----O-OOX---OBT----O-O--X-----------E------X------------T------|OE------------E--O----|---O--OXM-----
-------------E--T-O-O----------O-----O----O-B-|--|O?------X|------|---O-----|---------O--O----OX------------EO-X-|------O-O--------O---B---T---------------|----B-|OX------------B--X-B--|--------------
---------M-O-T--|--BO-?M-O--O-----------------|--|---------|MM----|-----X---|O-BO-----O--O------O------O----X-M--|BO--------OO-------------|E--O-T---------|-O----|---O---O------------ME|--OMM--------v
-------------|--|M----------O-X--------B-M---O|-O|O-----O--|--O---|-------M-|----------O----O---BB--E-----B------|--OE-MO----------------M-|B--XO|-------O-|MB----|T-----------------B--X|-------BO----f
--------B--O-|--|---------O------O------O-----|--|O--------|O-----|X-B-----O|-----?OOOO--O----E-----B-----------O|-XBB--------O------------|-----|-----O---|----X-X|-M---O---OO----OM-O--|-----X-------f
-------------|OB|---O------------O---E-----B-O|--|O---X--?-|------|O--------|-----------O---OXBB------O-----T--X-|--O-------B--BOE-OO------|--O-O|----O----X-----T-|----OOX-----O------E-|----O-O------f
-----X---O-OXXO-|-----E-----O---OEO-XT-----OO-|--|OX-------|O-O-B-|-------O-|----B-O---O---OBO--O---O-B---O-|----|--------O----OE?--O------|----O|--OB---O----?-O|-|-O-----------------B-|X--OB--------f
----------------|-----X-----O----?---|--BB----|OO|--------X|-MX---|----X---?|-O----BB--X--------X-TO--------|----|----------O---?--M----X--|-X--O|--XX--------O--|-|----------OB--O------|MO---?--M----f
---o--------ooo-|--------------------|--------|--|-o----o--|------|---------|---------------------|-ooo-----|---o|------o------ooo--------o|-----|----o---o------|-|-------------------oo|-------------f
m-o-------E-----|----o--o--o--E------|--------|oE|-----E---|------|-------E-|-----------o---------|-o-------|-ooo|EE--o--o-E-----------ooE-|Eo---|----EE--Eo--o--|-|---------EooE---Eo-E-|-------------X
XXXXX-X---XXXXXXXXXXXXX-XXXXXXXXX-XXXXXXXXXXXXXXXXXXXXXXXX-XXXXXXXXXX-----XXXXXXXX----XXX--X-XX---|XXXX-----XXXXXXXXXXXXXXXXXXXXXXX---XXXXXXXXXXXXXXX-XXXXXXXXXXXXX|-----X-X-XXXXXXXXXXXXXXXXXXXXXXXXXXX
