---------------OOO---------OOO--O---O----O-OOO--O----O-O-----OOOO-O-----E------------O-O--OO------OO----OOO---O---OO-OO--------O-O-O-----O-O------OO-OO---OO---O----O-----OO----OOOO-OOO--OO---O-O--OO-E
--------O--OM-OMOO-O---O-BB---?--O-O--OO--ETEEOOOOT--?OTE?-O-M-----OO---B-OOOB-OOBO--B---O-O--XOMBO-OOX-----OOO-O--XOBOOOO?----BO------X-OBB---B--OOOO--X-O-M----OO-O------X---O-O-O--O-O-O---TOO-OO-O-T
--O-O----O-O----O--E--B-OOOBXTO-OOOOX-O-O-X|TB---O|O--B|BO---XOOX-OMO-MO---O-OOO?-?-O---------OO--OX-O-TXXOO--OTO-O---XO--OO-OTO---O-OO-B-O-E---TO--OOO--E----O-O-OEBBXO-M-O---M-O--BO--O--M--|OE-MO--X|
--O-------OO--O-?OEB--OOB----|BOO---OTBO?--||BO-B-|--OO|OO--OOXOOO--BO??-OB-OOXOOO-T--OX?--O-O-TOOO--O-|-OXB---|M-M---B----XO-|O-OOBOOO--OO-XOO-|-OBOOOOOB--O--OO--M--OM-OEO?-----OO--OMO-O-XX?EX--OB--|
--OOOO-O--TBEB-X-B?-O---OO---|-B-OB--|-OOBO||---O-|O---X-XBB---X-B---T---X-O-OO--O-|OE--O---XOB|-E-O--B|O-O-BO-|OXO-O-O-O---OO|O--------OBOOMX-X|--O?-B--OXTO-BXO--------OBBOO-E-OOB-O-O-O-O---M-OO----T
-O-OO-----|-?-O---OOXOOO-?TOX|E-OB--O|O-O--|MEO--O|OBOO-OM---O----O--|OO--O-E---O-O|OX-OOE--OO-|-?-O-E-|B----?T|E--B-----M?-M-??EE--XOXOO-OEO-OOM?-EO-----X|OO--OOOO--O-MO--O--MB-O---EOE--BO---O-OEO-M|
--O--O-OOM|---O-ME----OBO-|--|M---O-E|-MB-OM-X--B-|-O---O-E---XOO---B|E-O--XB-O-OOMBEOBOMXX--O-|O-?--TOM-BT---||TO--BBO----O-OOOBXOMOXX--O-B-OOO--OX----O?-|-OE--E-O-BOOXO--EOO---?OO-X-BXM---OOTO-X-XO|
-O-O----O-|EEO-E-XO?O--OMO|-E|--O-OMB|-O-XX------EX-O--MTOMOBO-EOBO--|BOEX----OX-OOOX---O-OO-OO|-O-OM|----|OBO|||----B-OO-O-O-OO-O-O----OO-OM----O?O-MO?O-O|XEB-OXEOXO-M-BOBB-?---O?T-OOO--O--OO|------v
----O-B-E-|MX-TME-O--O-EOO|-X|O--OOO-XOO?O-O-EO-O?O-?OOO|O-OBOOMOO-OO|O-X----OX-E---OOOE---MO-O|OO--O|OO--|OOX|||OBE-OXOOB--T-O-----O-OTOOT--O-O-TO-B-OOM-OX-MOE-OBO--OO--X--OOT-OOB|OOTO-XXMMOE|---O--M
-OO-OOO-BXBOOO|-XO----OB--X--|OO-MO---B-O-O-OM-BM-OM---O|--------X-BX|---OOO--O-B-O-OO-B-X-O--?BX-XO-M-OBOX-OOB||--B-B-OOO-M|M--T-T---X|--|O-XMXO|-O--O-----O--T--OXOM-OO-?E---|O-O-|O-|----O-OX|-E--?BO
----O----OO---|O-BBOOOOOO--OOB-OOO-----O--OX-MO--OO---OX|EOM--B---B--|-M-XOX--E--BB---M-O-BOE--OO---M-BBOOO----M|OO-EOE-XO--|-O-|O|XO--|XB|TO-O--|OBOXB--OE---EX--O-O----M-BOOX|B-MO|-E|EO-EO--O|OBX----
-------OOOOO-?|B---OOBO-XOOBBO-B----XXO--E--OOOEOMM--OXO|X--O-OOOOM--|B----O?BX-E---T---TEB-TXOE---M?-O-E---OMXO|-OO?OB-----M--O|X|---OBOOM|O-OO?M-----OOOB---B--EXO-E-EX-E--M-?OO--|OX|M-EX-OX-B?O-O--O
--M-BXM-XB-OMOXOBO--O-O--XX-O-BOO---O--O-XM?OOOBB--O----XO-OO-OOBOO-BMOOMOM-X-OXX-O-|O--|?O-|-XBOT------B-OBO-O-?-?X-X-X--MTOMMXX-|--?BOO-O|OB-OO--OO-O-X-OMX--OO?O-OM-M-OM-?--O-B-XBB-|--B-BX----OOM--B
-o-oo---o-----o-oo-o----o-------o---------o-----o----------------oo-------oo--------|---|---|oooo|---------oo--------ooo-o-|------|---o----|---oooo-o-----------------o------------oo--|----o-o--o------
m-----oo--------E--Eo-Eoo----------o-Eoo--o------o-EE-o--------oo---------o---------|---|---|----|------o-o-o--o--------oEo|------|--------|---E----o-o--------E-----o-----------o-o-E-|------o-E-----o-
XXXXXXXXX----XXXXXXXXXXXXX------X--XXXXXXXX-----XXXXXXX--------XXXXXX-----XXX-------|---|---|XXXX|------XXXXXXXX-----XXXXXX|------|XXXXXXX-|---XXXXXX-XX-------X----XXXXX--------XXXXXXXXXXXXXXXXXX--XX--
