--------------------------------------------------------------------------------------------------------------------------------------------------------------------------------------------------------
---------------------?OB---OM--E-B-----O--?----B-O--M--------E-----------XO--------------------T----------BO-------------------X-----?-------------------O--?--O---------------X----M------O------------
-------------------------O-----X-----------O---OM-O-OO-------XO------O-O-M---O---------O-----O-|OB--O--E-------O----------------OO------O-----O-OX---O-----M----OB--M-O-----------O---------------------
--------------------------MTM-O-----O--------O---M-B-X--------O---O-O-O-------?-O----O----EOO--|-------BMM----O-----OX------O-----O--------O------M-OOETXB-------------X------------------O-O-----------
---------?----------OBO-ME-|--T---O-----------OOO------------------BE--O---O---O-----OBXO-XO-O-|-O??-----------------O-XX-----B--O--O--------O--M--O--X|-O------------O----------X---X---M--------------
------------------X-OOO--X-|--|-----O----O-X-----E------------O--O--?-------M--O---OO----O-----|----------MB----------------O-O-----O----M--OE-E---M---|--M--------OO----OM-?-X----OOO-O----------------
---------E-O----------B---B|--|-BEOO--------O----X---O--O-----M-O------E-B-----------OO--------|-----O---M--O----O---------O--OO---O-O-------??B------O|-M---M-M--O?---------M-O----E--O-----?---O------
---------?-O---X-O------T-O|--|-OB-O-E--OB--------O-----M---X--M-----O-M-----O---EO----------M-|----------------T-X---O---?OO---------------O-----X---B|----------XO---------------OB---------O--------v
-----------O-M------OB--|--|-O|------X---O--M-EX---O---O-------OO--O------OO-----XX--E--M-E----X--O-B--O----O---|--------------X--M---O----O----E------|O------O----B------T---O-B---E------O----------f
----O-O---X-------------|--|O-|-?-------------BOX-O--O------O-----O----------X--BO---M----X----O-E-------------X|--T--B----------------B-----M--T-----O|---------T---B---O-|--O--O--OB-----------------f
-----X---X--?----O-X----|--|-O|--------------O--O--------T---XBOXO---M--XO--------E-------O-OM---M-----------OOO|--|--O-B--O-?----O---O-----E-X-|------|M------O-|EM----O--|---------------------------f
----------O-------O----O|--|--|-----------T-X-E------O---|OOO--O--O---------------X-B-E--E-MB--B----?-E-----O---|--|-----OE-BO---O-OO-------B---|-----X|---EO-X-E|B---X----|-E-EO----O----T---O--------f
--XB----------OO-O----O-|OX|--|-------O---|---X-O--------|O--O--------?---B-O------OO-M--BOO----------BB-------O|--|B----MM---T-----M---O-------X-M-B--|---B--O-M|-OB------|-?-M----------|-----O------f
------o---o------oo--o-o|--|--|--o---o-o-o|-----o---o----|-----o-------------------------------o---o------o---o-|--|-----o----|---o-------o------------|---------|o--------|--------------|-------o----f
m---------o--------E-E--|--|-o|-o-o-------|--------------|--E-E----------------o--o--o----------o--------o-o----|EE|---------E|--E----------o----------|---------|---------|E------EE-----|------------X
XXX---X-XXXXXXXXXXXXXXXX|--|-XXXXXXXXXXX-XXX-XXXX--XXXXXXXXXXXXXX--XX-XXXX--XXXXXXXX-X--XX-----XXXXXXXX---XXXXXXXXXXXXXXXXXXXXX--XXXXXXXXXXXX----X-X--XXXX-----XXXXXX-----XXXXXXXXXXX---X-X---XXXXXXXXXX
