--------------------------------------------------------------------------------------------------------------------------------------------------------------------------------------------------------
---------------B--E--------?--O---------ME----------------------X------------O---B-----------------O--O----B-O--------------BO--E---------M---B--OO---------O--X--X---------B--------B----T----O--------
----------------OE?-M----O----OO---------M--EE--X---------BO---------------------O-----O--O----M----O-----O------OO-------------M-M--------------O---E-O-------B-O--------B------------OO-|-------------
-----------------B-E----B--------O-E----O---?B------?--O--------O--------T------X------B---------O---------O---O-O-O---X--O-E-------MO-----------O---X-X-OOO--?-----O-----O-O-------TE----|------O------
--------X------B--EM-O-----M------BX-----O----T------O--OB-----O-----?---|----OT-----O-O----XM---------E-O-OE--OOO-----O-E--B----?--O---------M---?-----B---X-----------M-O----X---X|X-X--|---OO-EO-----
----------------O-B---OO--------O--OXE--------|--------O----M-O----------|-----|E----X-----OO------E---?---OB-----------OX--O--------O-O----------OB--MO-M-X------OTM---------------|-----|------X------
----------O--BX-------O------OO----O-B-XM-----|XE------O--------O---O----|---M-|B--O--B---B-------BMM-----BO----M-OM-------O-----------------X--O------M--O--O---E-|---O------------|-EOB-|-----B-------
---------------O-----------------B--O----O--E-X-B----B----------TO--MO---|----M|---OM-OO--------O-O-----B------E----------OO-T-MB---O----M--------?-------B--O---T-|----------------|-M---|------------v
---------O--O---BOO----M------------O----XM-B---O-------------O-|----B--?|B-B--|--X--O-----X-O-------------O---?--EO-O-------|M---O-?---M---O-O-MO------O-OX-----|X|--------O------T|----O|------------f
-------O---------OBM-------BBOO------------?----O-E--------O-B--|-----X--|-----|------OO--------B-O-O--------O----?--B-------|-----O---TO---B-O--------------O---|O|-?------E------||-O---|------------f
-------------XO-------M--------E-B------OE-----B--B------O----O-|--OM--OO|-X---|---------O---------O-T--O-------T-----O-T----|--M------|---X----------B---------?|-|---M----?OO-?--||O---O|--OEO-------f
-----E--XO---OX---------B------M--O----O-B-O-------O-----O----O-X--------|--M--|O-------------B----O-|---B------|M------|O-O-|TM-----O-|------O-O--------E-T-----|-|----OO-O-O-----||-----|EB-BE-------f
----BX----------B-B-----O--X------O--O-----O--O-----O--B-OOB------------B|--OM-|-O--O-X-OBO-O--------|---O-----O|------O|----||---OBO--|----X-------B--XTX-|-----|-|------X----?---T|-O-O-XMO--M-O-----f
----------------o---------oo--o--------o---o----------------------o--o---|-----|------o-----o--------|o-------o-|----o--|----||--------|----------------|o-|-o---|-|------------o--||----o-------------f
mooo---------------o-----o-oo-o--o----E-----EE-E------oE---oEo----E------|-----|-E--------------o--oE|---o---o--|---oE--|EEo-||-o--E--E|--o----Eo-------|--|o----|o|------o----E---||-------o--o-E-----X
XXXXXX------XXXXXXXXXXXXXXXXX-X--XXXXXXXXXXXXXXX----X-XXXXXXXXXXX-XXXXX--|-----XXXXX--X--XX-XXXXXXXXXXXXXXXXXXX-|-XXXXXXXXXXXXXXXXXXXXXXXXXXXXXXXXXX--XXXXXXXX--XXXXXX--XXXXXXXXXXXX|---XXXXXXXX-XXXXXXX
