--------------------------------------------------------------------------------------------------------------------------------------------------------------------------------------------------------
---------------?------------------------------B----?-X----------------------o-------o------?------o--------o?---o---E-----o--------------Bo----------o---M--o-----o-o-----X-X---B--M-----------M--------
-------------------o-oo--------B-E--X---E----M-----o-----------o-----X-------E----B----------XB-----------Bo------o-M--------------o-o--------------oo-o--T--------?--o---------o-----------------------
-----------E-o----o---o----------T--o---B--Xo-ooB-----------------o----B---E-X-oo----E-----------oo------o-E----------------------Xo------------------E-o-|o---E------o---o-----oB-E------o-o-----M-----
-----------X--E-T-----oo---------|--X-------B--o---------------------------B?--oo----?---M----oo-----------T-----------o---Eo------o-----o----?BXo----M---|--X-B-o------M--------o-B-oo------Mo-XB------
--------T-oo--B-|----------X-----|X---oX-oo---------------o---X-------o------------oB-------------X--------|-----B---o---o-MB----o----T------B------------|-o--o-B---------------o-o--------M-X---------
--------|--M----|-------o-o---B--|-oo--------E-o--o--?--B-?--X---------o----oB--o-o-B------------X--o-o--E-|-------------o---oo-----E-|-----B--------o-o--|---?----X----o----o-------o----X-o--M--------
--------|--oo---|----------------|-B-E-------Xo--E-------E----------M---------M----o------o----------o---B-X--oB--------Mo--------o-T-|-oEo----------oo-o-|-E-o-E----E--oo--------E--T--E---------o----v
--------|--o--o-|--B--------E----|---X------B--o?X----M--Bo-----------------M-o--B-o-----o------o-----------EE-oo-------------BXo--X|-|--T-----o-oX-------|-Bo--B----T-o---M------X-E|--BX-oo---T------f
----B---|X--M-X-|-------o---Bo---|------M--o---?---oo-o------o---T-----E-o-o-o--oo-?----o--E-o------B-X-----TB------------X-T-------|-|--|-o--EM-----o----|----X--E--|X-X---X---o---B|-------oB-|------f
--------|-------|o--E--o--------EX---------?o--------------------|-----?---X---BooB--------X----o----X------|----------X----|?---o--|-|--|----?o----------|o---oo-X-o|----Bo---o---o-|BM--------|-o----f
--------|-------X---?o-B---o---B?----?-o--o---------M------------|--B---o---E-------?-------E----o--------oX|-----------MB--|---T---|-?--Bo-o----oX-o-X--o|---B-----B|-------oo------|----------|------f
--?o---o|-----------------B---B-----ooM------o---o--------o----oT|-X--------T---------------X---------o---oo|---X-----------|---|--oX-M-------------------X----------|--M-o-o----T---|o---------|------f
--------|-------o-----o---------o------------o------------------||----------|---o---------------------------|--oo-o-oo------|o--|-----------o--------------o--------o|-----------|o--|-------o--|------f
m-------|-E-------------Eo--------------------E---E--o-E--E-o-E-||----------|oE-------------o-E--oE------o-o|----o--------E-|---|E------------o----o-------Eoo-o--ooo|--------o--|---|-E-E-----E|------X
XXXX-XX-|-XXXXXXXX---XXXXXXXXXXXXX--XX--X-X-XXXXXXXXXXXXXXXXXXX-||-X--XXXX--XXXXXX-XXXX-XXXXXXXXXXX-X----XXXXXXXXXXXXXXX--XX|XXXXXXX-X-----XXXXXXX-XX---XXXXXXXXXXXXXXX---XXX-XXXXX-XXXXXX-XXXXXX-XXXXXX
