------------------------------------------------------------------------------------------------------?------------------------------X------------------------------------------------------------------
------------o--------------------------------------------------------------------------------------------------------M----------------------------------X--------------------------B--------------------
--?----------------------------------------------------------------------------------------------------------------------------------------------------------BBBBBBBB-----------------------------------
---------------????????----------------------------------------------------------------------------------------------------------------------------------------------------------o----------------------
--M----------------------------------------------------------------------------------------------------------------B--------------------------????????--------------------------------------------------
-----------------------------?????----------------------------------------------------------------------------------------------------------------------------------------------------------------------
-----XXXX----------------------------------------------------------------------------------------------------------------------------------------------------------------------------------o---?--------
-----------------------------------------------------------------------------------------------------------------------------T-------------------------------------------------------------------------v
--------------------------------T-------------------------BBBBBB-------------------------------------------------------------|-------------------------------------------------------------------------f
-----------------------------T--|-------------------------------------------------------------------------------------??????-|------------------------------------------------X-----------------------of
-----------------------------|X-|--------------------------------------------------------------------X-----------------------|------------------------------------------X-----XX-----------------------f
------------------------T----|XX|------------------------------------------------------------------------------------------?-|--M--------------------------?------------XX----XXX----------------------f
------------------------|----|XX|----------o-------------------------------------------??o?????------------------------------|------------------------------------------XXX---XXXX---BBBBBB------------f
-----------------------?|----|XX|X-------------------------------------------------------------------------X-----------------|-----------T---------------T-------------XXXXX--XXXXX--------------------f
m------------E----------|----|XX|XX--E----E-------------------------E-----?--------EoE------------------EE-XX----------------|------E----|-E-------------|-----XXXXXXXXXXXXXX-XXXXXX-------------------X
XX???????----XXXXXXXXXX-|--XX|XX|XXX-----XXXXXXXXXXXX-XXXXXXXXXXXXXXXXXXXXXXXXX--------XXXXXXXXXXXXXXXXXXXXXXXXX-XX--XXXXXXXX|XXXXXXXXXXX|XX------XXXXXX-|--XXXXXXXXXXXXXXXXXXXXXXXXXXXXXXXXXXXXXXXXXXXX
