--------------------------------------------------------------------------------------------------------------------------------------------------------------------------------------------------------
------------------E------O-------------------------------X--------------------O----M-M----------OM-----OE--------M-O-----------------------------------------O------O---BM-BB---M--B---OO-MM------B-----
--------------O---XOB-----B-T--------B---X--O-----B---X----OT-B------O----B---------O--X----------OX----XO----X---O----------OB-O--------------------X--MM-O---X---MB------------TB------X-------X------
---------------EO--------MO-|-O---------O----O-----X------OX|--X-O-X?--------O-EB--O--O---------------------XO----O----O-------------------O---O-----O------------X--O--E--------|-------------E--------
----------O----X------------|?E--O-O---OXO----E------M----B-|-M------------MB--X-O-------B----------XO---X--------------------O--O----------O-O----------------X-M---O--MO-----M-|----O-O--OXO-MO-------
---------------------B------|-T-OB------------B-----OO--T---|---X------O--------------------O---B------O------O---OBE-XX--------------------------------X-E---O----?----OB-----OO|---B---T--O-X--O------
-----------?--------------?-|-|?-E----T------O---O------|---|------B-----XOOE-BM-O--OB----------O-----XO--O-------B-B-O-O----O--O---------------O-X---O-BOXB--------M--O----O---X|M----O-|-------O------
----------T------O---O---O-O|-|O-B--OT|------B-----O----|--O|---O-O-MB---OO-?------B---O---E----------O---B--OM----O----TO?O------OE----X-M----------T-M---------M-T----?M-B----O|-M---X-|-----OE------v
-----B---O|------OE--B---O-B|-|------||-X---------------|--O|-------O---B--------E-X-OO--O-X-O-X---O------O-------O-----M--O-------B---O-------O-----|O----O-O-X---|---------T---|-OM----M---O--?------f
----------|---X---X-OO-O----|-|--O---||OO-OO-E---O------|-X-T---B---O---------O--BO-XO----B---------------O----O--X-------XO-------------X-----------|------B------|-----O---|?-O|-----O---------O-----f
----------|--X-T-O--B--E----|-X----OO||------BOOB-OX----|---B-----O--------XX-?---B-O-----------M---O-O-----X-------O-------------------O---XO-----O-|--O-O--------|---OOT---|O--|-----TO-O-M----------f
---T--MT--|----|-------?----|---O--T-||---O-XO----O--M--|---O--O--B-?--O--?-------------O-O-OOO-B----------------------O----XO---O---B--?-------XO-O-|--OB---------|---X-|---|---|-----|------X-O------f
--M|-O-|OOM----|------O----X|OO----|O||MO-------------O-|-M--O-B-O?-----------X--O--------------------OO----------TOBO-O-----------B-----OB---B------|--------O----|-O-OM|---|-TO|---O-|--M----OB------f
---|---|-o----o|----o---o---|------|-||-----------------|-o------------------o---------o-------o--------o----o--o-|--o-------------o---------o-------|--o----------|oo---|--o|-|-|-----|-o-----o-------f
m--|---|------o|-Eo--o-o----|--E--o|-||--EE-----o-------|-o--o----oE-----o-E-----E----------------o-o-E------E---E|--o--------------o--oE--------o---|-o----o------|-E---|-E-|-|-|E----|---------E------
XXXXXXXXXXX---XXXXXXXXXXXXXXXXXXXXXX-||XXXXXXXXXXXXX---XXXXXXXXXXXXX-----XXXXXXX-X-----XXXXXXXXXXXXXXXXXXXXXXXXXXXXXXXXX-------XXXXXXXXXXXXXXXXXXXX--XXXXXXXXX-----XXXXXXXXXXXXXXXXXXXXXXXXXXXXX-XXXXXXX
