--------------------------------------------------------------------------------------------------------------------------------------------------------------------------------------------------------
--------------------------------------X---------------------M-----B-------B----O---E-----B----------E-O-----XO--------O--?-----O----O--------------------B-OO---------------------------M---M-----B-----
------------------X---BO----------------E-----O----O-O------------OB----M----------BXOO--------B--E-B------X-----OO-TE-------OO-----O---------X-----B-E-O-O-----------------B-----------O-------B-------
-------------------E----EO--------------BO---?X--OB-?---XX-O----------E----O----------------X-----T-------E------B-O|X--E------O-------?---E-M--O----XX----O--O------B----------------T-----------------
---------------O---M----XB------E----O-----?B--------O-O------E----O--X-O--X-O-------OOB--OE------|-------B-X----OO-|-B-?--O------------O--X---T---B-------O---------------O----------|---X--O--E-------
---------------------O--------O-XO-----O---OO----O--OXO-------T---------------O-E---MT-----?--O---|-------O---------|--O-----M---O-----BO------|------OX---OB---X--O----OO-O--O-------|---O---O-B-------
---------O-BO--OB------E-----------O-E-OO---------O----OO--BX-|----O--O--B------B----|---T-------E|--EOE--------B---|-----X-X--O-O--O---------O|---------O-O--------O---?-------------|O----B--O--------
----------O------OX----B-E-----O-----T-O------------B-T-------XE-------O--T----------|---|-OOE---XXX-MOX---------O--|O---------O-TO-------O----|----O----?-----O---O--O----O--O---B--O|----------------v
-----------------------O-B------B----|----M--------O-O|-------O?O-------O-|--------O-|---|---X------X---E------?O---|OO----------|----OO-------|?-----?-O-O-O--------E---?--O--E------|O--BB-----------f
-----B------------O---------------O--|-O--------XO----|----------M--O-----|-O----MM--|---|-O------------B----O-O----|E-----------|M-OX---------|---B--O-O-------O-B--B-------E-X--O---|--O-------M-----f
----------O---OM----O---OO-----------|--T--B------O---?--M----O--O-OO--X--|--O-------?---X?-----X-----O----------OB-|X-----------|---O--OE--B--|-------O-------X---------O---M-------MM-M-------E------f
---OB---?B---O----OOT-------B----M---|-O|-----------------BB-O-XE---O-----|B--------M---O-O---O-OOO-O--O--------O---|-----B------|----OB-B-O--O|-O------M---O---OB--O-O-----X-O-------OO-O--O---B------f
---O-B----X---------|M---O--------X--|-O|---B------------------OX----OO--O|-?--O--O---O-------OO-------T-O--OO----O-|-----------O|------O------|--?----O---------------B-O---OO---BM----O--------------f
--------------------|--o-------o-----|--|----------------------------o----|----o----------o--oo----o---|o---------o-|------------|-------o--o--|-------------o---------------------o------o------------f
m-ooE--Eo--E--------|--o-----E--o----|oE|--o-E-------o--o-----o-----------|--E---E--------o--E---------|------------|------o---oE|------Eoo-o-o|----Eo-----o-----oo--o-------E-o---o----E---------------
XXXXXXXXXXXX----XXX-|-XXXX--XXXXXX--XXXXXXXXXXX-----XXXXXX---XX--X-XXX----XXXXXXXXXXXX--XXXXXXXXXXXXXXXXX--XXXXXXXXXX-----XXX-XXXXXX---XXXXXXXXXX---XXXXXXXXXX--XXXXXX-----XXXXXXXXXXXXXXXXXX-----XXXXXX
