--------------------------------------------------------------------------------------------------------------------------------------------------------------------------------------------------------
--------------------------B--------B------------o-----E---o---------o---o-?----------o-T----------B------o-Bo---------o---------X-X-----B-----oB-----oo-----------B-------o-------o-------------o-?-----
---------------------o--B-o-X-----X-Mo--o---M--B----MoM----------------o-o--------o----|--------o----o-o----------------oo?--------X-------o--o-M--o----o-X-M-----o-X-------o-------B----------o--------
-------------------------------?o------X-------o---X---o-B-o--o------X---o--------X----|--o----------o-------o------oo---Mo-----------------------B---X--M-X---------oo----------------o-------o--------
-------------------o------------E---------E---M-----o------------o----------oo--B---o?-X--M-B--------------oo------oB-------o--------T---oM--T---o--o----------X-----o---o------------o------E----------
------------------o-?------o---oX--o------B-------o--------------------o---o--------------o----oo----B-----------o-X------------B----|--T----|---------X-------------o-o---o----------------oME---------
------------------B--o-M--------o--------------M-X-X------oo--X---?--------o------o-----oo-B-Mo-----o---B------oE--------------------|X-|----|-----oo---o?---------o--M-----E--ooM------------TX-o------
--------------X----------------o--?-----o-E------o--o--X---o--------oo-X--o------------o------oT----------B----o?-----------o-B---E--|--|-o-o|E----o----X--oo------MoM------X--E-------XB-Mo--|--------v
-------------------E-o-o-----------oE-----B-----o-------X---T-----oo------X-o-X-B-o-----------o|---------B------oo-------Mo---o-B-XE-|-o|----|X----?-----------M------o-------MB-------o------|--------f
----------X-------oX-X-B--E----EE---B-o------B-o----B-----o-|o?--o------o-------o------oMo-oEoo|---B-o-o------M---o-T--oo-o-o-----oB-|B-|---MX-o----------------Xo----Boo--?-----E--------E--B|-?------f
--------------E-o----X----T-B--TXB-----X---oo----------oX---|----o------T------o--Mo--T-oo--?-T|-------------------M|-----o---E-o----|--|-------oT-----------o---------------B---XooB-o---X---|--------f
------o----o-oX-----o--o--|---X|------------o-X----M--------|---E--o--o-|----E--------|-o---o-||---o------o-X------o|---------X--B---|--|------B-|---E-----Bo-----------?o-------o------o---o-|o-------f
--------X--B---X------o---|----|----------------o----o-----M|---?------X|--B-XBo-Xo---|---B-o-||X------o----o-------|--------------B-|--|---o----|--oM-----o-?-----o------o--o----------------|--X-----f
-----------------o-o------|----|----------o-----o------o--o-|--o--------|----o-oo-----|-o--o--||--------------------|o-----------o---|--|o-------|-------ooo-----------o----------o-----------|--------f
moo-----E-----------E-----|----|----------E--------------EoE|-o---E-----|-----o-------|--E----||--------------------|-oE--o-oE---o-Eo|--|--o-----|----E-o--------------E---o----oo--o---------|--------X
XXXXXXXXXXXXXX---XXXXXXXXX|----|----XX-XXXX-----XX---XXXXXXXXXXX--X-X-XX|XXXXXXXX----XXXXXXX--||--XXXXXX----XX-----XXXXXXXXXXX--XXXXXXX-XXXXXXXXX|----XXXXXX-XXX--X---XX-XXXXXXXXXXXXXXXXXXX--XXXXXXXXXX
