--------------------------------------------------------------------------------------------------------------------------------------------------------------------------------------------------------
------------------------O----OO-X-----B------O-------O--O------------------------E--O------------------------------B---------------M--------B-------------------X--------------O--O---------------------
--------------------MBX?------------O-------O-OOX---------O----------------------M-----X----------B------X-E-----O---E---O----------O----OO-?----------------EO-O-------OO-O--------X-------O-----------
---------------------O---E---O--OM--M------OO-X-O----B--M---O-------------------------T----EO-------O------X--------OM------------O-B---B-------------------OM----O-OX--B-------------------------------
------------------B-O----XO---O---E------B--------O----O----------------------O-----O-|---MX---O-E--------------------O--O-O-----O-O----O-----------------------------O-O---O------O--------------------
-------------------XO---O--O--O---M---------------------O-M--------O--O-------B-------|-X-O------B--T-M-------X------------O-O?O------M-O----O---O---------M-----OB----O---E------------------O-O-------
-------O----O---O--------E--X--O--O--------M--E---X--------B------O-O-------O---------|-------------|-OE---------M-----O---XO---------O--O-------------O--O------X--T------X-------B--O--O-O------------
-------O------E----O-----B-----O-O-----O------B-----O-O------M--O-EO-----OO-O---B-----|-------------|--XB----BO-O-----BM-O-E----OBE--O---------------B--------------|----------O--------OT-B---B--X----v
--------O--O-O?--E---?----X-----------O------------B---O-O--MO---O?--O---M-----E---O--|-O----------O|----O-----OO-O-----OO-BB-----B--X-O--O---------O-O-OO--OO------|---?--O--OO-----M-O-|X------------f
------O-O--------X-O---O-----XE-X----E-O------OX---------E-O-O-O-----------X---T---OX-|-----XOO-----|-----------M-------O----O----------E--M-X--T?-----O----E-----OO|----------O-MOO-O--X|-------------f
--------ME--O---X-O--O-?O---X-X--O---B-----------B-------B---O--O--------------|OBO---|------O----O-|-BO--BB----O----O----OO--------B--TT------B|---B-----T-X---?--E|--X-------B---O--OB-|OX-----OB----f
-----O---T--O-O----------O---O------------?X---OE--B------OBO------O-O----O----|------|-X-?O--------|---M--------------BX--T---------O-||B------|--O------|--O-----M|--O-O-O----E--O-----|----E--B-----f
---B--OO-|OO-----MO---M--O--XX---------------O--?---O-------B----------B----M-O|---X--|-------------|-------M---------X----|---TM-OB---||-------X-----O---|X--------|O-O--M-----?-O---O-B|----X--------f
-----o-o-|o--o-o-------o----o-----o-o--------------------o---------------------|---o--|-------o---oo|------o-o-------------|o--|o--o---||-------o---------|---o-----|---------oo---o-----|-----o--o----f
m-----o--|----------o-o-o-o------o----------o----o-o----E------------------o-o-|-ooE--|-----oE------|o-----o-E----E--oE--o-|o--|-ooE---||--E--------------|-----oo--|o--------------o--E-|o--o---oo----X
XXX--XXXXXXXXX-XX-XXXXXXXXX-X---XXXXXXXXXXXXXXXXXXXX----XXXX-XXXXXXXXXX---XXXXX|XXXXXXX-----XXXXXXXXXXXXXXXXXXXXXXXXXXXXXXXXXXXXXXXXXXXXXXXXXXXXXXXXXXXXXXXX--XXXXXXXXXXXXXXXXXXXXXXXXXX-XXXXXXXXXX-XXXX
