--------------------------------------------------------------------------------------------------------------------------------------------------------------------------------------------------------
---------------------OX-----O----O--O----------O--------------------E------------O-B---O---O--------X---------------M-------------------------O---O--E-------E---------B----------O------------B-X------
-------------------O------X--B---EO-------T---O-----?------O---X---OT--------------O---O--X--O-OB--M---M-------O---X----O---------X-M--O--X----------M-------M-------O--T----O-B---------O------O-------
--------------------OE-----------BM--O----|-------BE----------------|-X?--O-----------OO------O-------T-----O-------------O-O-----OO------------O--B--O-----O---O---O---|------O-------O----------------
----------------E----B---O-----OO--------E|--------T----------O-B---|------------X------O---X-----E--X|----B--------B------O-------B-BB-O-X-----O---------------M------X|-OM--------E---M---------------
----------------X--O---------O-----------B|T-------|-OO-E--------O--|-O----OOO-O---OMO--?---O--O-BM---|---O--------M-------O-----------O---O--B--------O--O----------OB-|---O-----OO?----------O--------
--------------------------OT-TO---O-O-----||O------|--E-B-----?-----|EE---------B--------------X----M-|---M-O--O-B-?--------------E---EOO--OO--O-T---B---B---E-------O-O|M--------O------X--------------
--------------MB--B------E-|M|---O----O-B-||O------X--B--X--E---M---|BX--O-----O-E---OM------?-----O--|---O-M---O-O---OB---O--X---X---XE--BO-----|-----------X----------|------B-OX----------O-O-------v
----------O-------------EB-|-|------O----?||-----OO----O--O-TB---O-O|--E----M----BX------X-----E------|----O-M------TM---O---------O---B------O--|-B--M----O------------X----------XXO?---O-O----------f
------O--O---X------O---X-E|-|------------||M----X----------|-O-----|O-X--------O-----------O--XX---O-|-O-O---O-O---|-----O-B--------O-----------|O----O---------O?-----------------O-----O------------f
------O-----O------B-O----BX-|-----OO-B---||-O-----E---E---?|OO-----|---O-------------M----O---OO-----|-OO--O----EO?|O------O-------------O------|--O--B----------------O-----T--------M-X------TXO----f
---?X----------O---O--------E|-B-----T----||----B--X---M-E--|-----E-|---O-OO-----E---------------O--?-|----O---M-M--|------E-----B--X--B----O-B--X---O--E---X---EMO-----------|--O---O--O------E|------f
---------B---T-XT--O---O----X|-------|--M-||-----O-------MO-|----OB-|O--------B--B----------B--B-X----|----------O-O|------X-B--B---------O----B-O------B--X----?O-O----------|-----XOX--------B|------f
-------o--o--|o-|------------|---oo--|o---||-------o-----oo-|o-----o|-------------------------o-------|---o--------o|-o------------------------o------o-------o---------------|----------o-o----|------f
m-E-----o----|oo|o----Eo---oE|--oo--o|---o||----o----E------|-------|--o-E----oo-o-o-o-o-E------------|E-o------o---|--o----E-------EE----------E-----o--o---o--------ooEo-E--|------o-------o--|o-----X
XXXXXXXXXXXXXXXXXXXXXXXXXX-XX|--XXXXXXXXXX||-XXXX-XXXX-XXXXXXXXXXXXX|-XX-X---XXXXXXXXXXXXX----XX-XXXXXXXXXXX---XXXXXXXXXXXXXX-X-----XXXXXXXXXXXXXXXXXXXXXXXXXXX-----X-XXXXXX--|XXXXXXXXXXXXXXXXXXX----XX
