--------------------------------------------------------------------------------------------------------------------------------------------------------------------------------------------------------
----------------------------------o---oo----E---B---------o---X------B----BB-M-o-----oM----------------o--X---------------o-------------------o--oM--------X--o-o------------o-------o--o-M----X--------
------------------------B--M--E-------------BM---o-o-----X--------M-o-------o-----X------------X--B-----XX-------o------------X------------o--B---o---X-------X--------X-o---B------o----o---oo---------
----------------------o-------?--E----------------oX------o-o----o------X---M-?-----------------o----------o-o--------------E---------------o-o-----------------o--------------?----MB-T--o-oE--B-------
---------------------------T---o-XX------E-o----B----X-----------?-----o----------E------o---E-o----oo--------o---X-o-------B----------Bo------M--------E-o---o--------oBo-------------|-----?----------
----------------o---ooB----?--------o--X-B-B---o-------B---Xo---------E--M--------X-X-T----o-X-E-------T---M---------o--TM------oo----B-----------?-----B--------------E---------o-X--o|ooX-------------
------------X----o-----o----------oB--o-o-B-o-----------oX--M--------o?-E---oo--Mo--o-|--------X--B----|---o---X-----B--|-----------------Xo--B-----o--o--------o--Xo--X-E-----o--X--E-|--------o-------
-------------------o----o--o-oB---o----oo--o-------To-?---?-------X---o-?---o-------o-|?Xo-E-------o--o|--o-X?----?---o-|-------E--o----E-----------oo--E---------------oM-----------BB|o---------o----v
-------------X-----?---------M-------X-o-B---------|---BT---------o-----------Xo------M-o--B---o----o--|T--o----?M-o--X-|-o-oo--M---?---B-B----B---o----B--o-E-o------o---------Mo-----|-o---Mo--T-----f
--------------------B-----T---------------------o--|X---BX--o-----o--------o-X--------o---------o----X-||------o--------|---------Bo------------------X-----oB---X-----------E---------|-M-------|-----f
--------o------o----------|------------------------|-------o----o------o-------------X-Bo-------oX-M---||o--?-----------|--o-o-----o-o--o------o----X---------------M---o--oMBo--------|o-X------|-----f
----o----------oo--?-----o|---B----B-o-----o------o|-X-Xoo--o---------------o---o-----------M---o--o---||oo-------E---?-|?o------------X---B--ooX-o-o-----B-----o-------E----o-o----o--MX------B-|-----f
--o-------o-----o--o------|-----------o---T--M-----|--o---M----MX-----o----X-To--------------oT-oo-----||T-----o-BX---o-|--o--o-Mo---B---------X----o------------o------M---ooo---M--o-----------|-----f
-------------------------o|--o---o--------|--------|---oo---o-------------o--|----------------|------o-|||---------o--o-|---------o-----------o--------------------o------o--o-----------o-------|-----f
m--o-E---------oE--ooE----|---------------|--------|E--oE--o-E---------E---o-|o--o--oEo--E----|------o-|||--------------|-oo-----o-----o---E-----o-Eo------oE----------E---------oo------o--o-o--|o----X
XX-XXXXX-X-XXXXXXX-XXX---XXXXX-XXXXXX-----XXXXXX--XXXXXXXXXXXXX-XXXXXXXXX-XXXXXXXXX-XXXXXX-XXXX-XXXXXXXXXX-XX--XX-XXXXXX|XXX-XXXXXXXXXXXXX-XXXXX-XXXXXXXXXXXX--XXXXXX--XX-XXXXXXXXXX-XXXXXXXXXX-XXXXX--X
