--------------------------------------------------------------------------------------------------------------------------------------------------------------------------------------------------------
-------------------------------------Bo---X-----------------------------oo-o-----o-----o-o--o-X--o----o-----------------------o--E-o----Xo---------------------------------o-o-----o-----oM-X-----------
----------------------oo------------Eo-------E-B---------o----Bo--oo---E----------o-------E-o-o-----------o---E-E-E--oo-T--------X-----o----------------E---------?--B-o-o?-----------------------------
----------------X------o--o-o-o-----M--------B------X-?--o---------X---X-------Mo-----?---Xo-------E----------M-X-T--B--|-----o-------?---o----MEo---o--M------o--o-T--o-M--B--------o-----E---B--------
---------------Eo-------o-o--Bo---oM-------o------B----M--------o-B-------o-----o-o-------o--------M-----------oo-|-o---|-X-ooB-----E---E-M-----B----o-----------Eo-|----------------Bo-X-oB--o---o-----
---------?-----B-BX-------------o-----M-o-----o--------ooE-----o-o--o-M-------------EX--o---M---------B---o-------|-----|-----------M--oXo---oE-o----X------o-T--XE-|------o-----B--------M-----?o------
------------------------B--------o------------o-------B-oB-----o--o-o-------X------oX-----------B-o-X-----M------BB-----|---o--o-o--oo------E-?---o---o-?o----|--oM-|----o---oo----------------o--------
--------------o-----E--X------B----------o-X--o----?----M---?o-------M-----o--o-------Booooo-----------o-------oTo------|o---o--o---E------oB---o----o----o--o|oo---|-T----------------B----------M----v
---------o----T--E--B-----?o-----B---o------------o--o-X-E-------o--o-E-?------M-------X-----------B------E-B-o-|---o---|----------o?--E-----o---o------------|-----|o|------B---oB----o-o---B----M----f
---------BM---|--BT--------E--o----o-o--------Mo-B----o--B-----X------BE--------ooo------?---Eo---o-o?-Xo-M-----|-----T-|--o-EM--o-----M----oo--------o-E-----|-M---|-|---oM----X-----o--E------o------f
---------o--o-|-o-|---XEo--?-----------------o------------E-M-X-----B--?-------------o------BXooBB------oX-E--o-|o----|-|B-o-?---X-X-E-------------o--oXX-B---|-----|-|o-------M-o---o---X-----o-------f
-------oB-----|TX-|---oB----o------o----o-M-------oB-o----Xoo?--------o-----M----o-o-------E--o-o-----M----B----|-Bo--|-|--E----o----B--o-?--o-B-------o------|-----|o|-----------B-TE---------B-------f
-----o----B---||--|-----------ooo---------o------o-o--M-X---------------------------------oB------B---------M---|M----|-|--Bo-----------o--------o--o---------|?--o-|BB------B-o-o--|XM--------o--T----f
----o--------o||--|--------------oo---o-o---------------o----o------------o-------o--------------------o--------|---oo|-|-o--------------------oo---o---o----o|---o-|-----o--------o|---o--------o|----f
m---E-Eo--E---||--|---o-oEooE-----E--oo-----E-o----o-----oo---o----------EE--------E-------------o----E-----o---|--o--|o|-------oo----------o--------o-------o|---o-|-------o------o|---EE-oo-----|----X
XXXXX-XX--XXXXXXXXXXXXX-XXXXXX--XXX-XXXXXXXXXXXXXXXX---XXXXXXXXX------X--XXX-----XXX--XXXX---XXXXXXXX-XX--X-XXXXXXXXXXXXXXXXXX--XXXXX--XX--XXX-XXXXXXXXXXX-X-X|XXXXX|---XXXXXXXXXXXXXXXXXXXXXXXXXX|X-XXX
