--------------------------------------------------------------------------------------------------------------------------------------------------------------------------------------------------------
------------------M----o---o---------------------oX-M-----oo--------------X----------X----M------------------------------Mo-------------------------M-o--o------o---o---o-o-Eo--o-------oB-----X--------
-------------------------M--X---------------------------XooX------B---XXo---------o-----------oo-----------o-----o---X--------M-M------------------X-----o---------o--------MB----o--o-------oo---------
---------------E?-----E--------o--?------M---------------X----X--o-?---------oo---o-E---o-----------o----o-----------------------o--------------o------------------B--------o--oo------B----oE--B-------
----------o----B--E---?-?----------------------BX--o-----o--o--o-----oo------B----T-?-oM-o---B-------o-E-o----o---X-o---------o-o---------------E---B--M--M--M-o-o----o---To----------oo--o--?----------
----------o-o-----?o-?---o---------o------------o---o--------o----------oo--------|--------B------o----X----------------T------------E-----oo---?----------BE---BX---X----|oB----ooX--B-M---------------
----------X--------------------------X--o-----o------o-X--X---o-?X-------X--------|o-T------X---T-oo-----------X--------|---------Eo-B----------------o-----?-E---------o-|Mo---------o-----X---o-------
-----o-------------E--o---?--o--o-------E-----------------------o--------oT-----o-X--|o-----o--o|oo-----XM--------?-----|--------oB----------B---o-------o----Xoo--M---o--|--------------o--------o----v
--------------M--E-X------------o-------M---BE-----MXEX----------oo-------|E--EX--o--|---MTo--Eo|-----M---?--o--?M-o-X?-|Bo-Eo--X--X--o-o-o----M--------oo--------o-------|o-----oo----------Mo--T-----f
-----o----oo---E-M-----o----B--E---M----o----M--o----To--o-o---------Eo---|X--X------|o---|---M-|----X-o---B---o------o-|---X---------o-----------M-X----o-oo-------------|--EX-----------o------|-----f
--------E-X----X---------------X-?--X--o-B-----------|--o--o-----B---M----|o-----o---|--o-|-----|--------B---B----------|----oE------M--?-------oo------ooo-Xo?--o---o----|--B-o-------o-M--o----|-----f
-----o--X--------------E-----TTo--o--X-ooo-o-----X-o-|-B-------------o----|-M---o-M--|-o--|B----M------o----------E--X--|Eo---X--B-----o--Bo-o---T---o----------B-------o-|--o----B----B-------B-|-----f
---o-B----o-------M----B--T--||------------------o-B-|--BBX-----B----o----MMo---XX--?|----|o---o-o----X-M------o-BX---o-|M-o-----o-Xo-Mo------o--|o------X-o------o---?-o-|--o----------o--o-----|-----f
-o------o------o--o---o--o|--||----------------------|-------------------------------|----|--------o-o-------o-----o--o-|-----o------------------|------------------------|--o-------------------|-----f
m--o---o-o------oo--E-----|--||Eo------------E----o--|oE------E-o-E-o--------o-------|-E--|----------o-----oEE-------o--|Eo-E-o---------------E--|--oo------oo-----o--E--o|-----oo------------o--|o----X
XXXXXXXXXX-X--XXXXXXXXXXXXXXXXXXXXX-X-X------X----XXXXXX--XXX-XXXXX-XXX--X-XXX-XXXX-XXXXX-XXXXXX-X-XXXXX---XXX-XX-XXXXXX|XXXXXXXX----XXXXXX---XXXXXXXXXX----XXXXXXXXXXX-XXXXXX-XXX-XXXXXX-X--XX-XXXXX--X
