--------------------------------------------------------------------------------------------------------------------------------------------------------------------------------------------------------
------------------------X---o-------X--------oo-----o--------B---?--------------------M----------------------------o--------------B---------o-o-oo-----------------X----------o------------XX-----------
-------------------------o---------------o---------o-E----------?-----------M---o------o---M-o--------o-o------------------------X-----------------B---o-M--------o----E--o---o-------o--o--------------
---------------?---------o---o-BXE--o-------M------o-B-----o--o-X------o--------------------------------o---o------B-----------M?--o---oBo-----o-EX---o-------oo----oo-T---oo---------B--EE----B--------
-------------E-----------------o-X--o-oB---------o----------B---o--o-E-------------------------o----MoXoMEo-M--M----o-----X-o---------------oo-o-M-----o---------E-----|---o----------o--MX-------o-----
-------------?------o-------------oE----B-X-----M--Xo-T--------------B-------E-----XM-------o-------o----T----E-o-E------o---------M--X------X---------B---E-----XM----|-----o----B---o-oo------?o------
--------------------o--BX-----E-?--T-------E---------o|--E--o-----oo---X-----X-o--o-o------o------o-o----|---oB--BM---------o-------?----BMX-----o-E-------M-E---o-B---|------X----------------o--------
---------------o--M-?---------XM---|-------B--B--o----|-oXX-----o---------o-?o------ooE-B-X-------------X|-------o-------o---o---------------------B----E-Eo-?-o------?|--oT--ooo---E-----oo------M----v
------------------o------------o--X|--o--E-------XM-o-|o-----o----ooo------o----o-----M--------B-----o---|------o-X-o----------T-B---E-----o----E--o----X-X--o------oM-|-oo|---o----TM-?---X------M----f
--------Mo------------o--M--B------|--M--M----o----o-oX----X------------o----To-------o-o------oME-------|o----------To------EE|-----M----------X------------o--E------|--o|-------X|oo---------o------f
-----------o----M--o---oB--------o-|-X-E---X-----oo-X----Bo--o---------Xo----|-----E-o----o------B---M---|-E-----o---|-------BM|---M--Eo-------o---T---o---EB-o-M----o-|---|----?---|----------o-------f
-------o--o------------------X-----|---Xo-Bo-o-------E---oB-?---------oo---o-|-----M----o--T----o---o----|-BX---o----|---------|----o-B-X---o------|-o-----M-o----o----|---|------Bo|o?-E-M----B-------f
---o-----M-------M---o---------T---|----X-------M---oMo----o-B------X-?------|o---o--------|-----o---o--?|--o----M-B-|-XB---oo-|----X-------Xooo---|---o------o?-------B---|---X----|---B----?-o--T----f
-o---------------------------o-|o--|--------oo-o-----oo-o-------------oo---oo|-------------|o------------|--o--oo---o|----oo-o-|--------o-o-o--o--o|----------------o------|---o----|--------o---o|----f
m-----------------------o---Eo-|---|-------o--------E-o------oo---o----o---E-|----o--------|-------------|----o------|---E-----|--------o--o-------|---o-o---oE---oo-EE--E-|o--o--E-|-------o-----|----X
XXXXXXX----XX-XXXXXX-X-XXX--XXX|XXXXXXX----XXXXX----XXXXX----XXX-XXXXXXXXXXXXXXXXXXXX---XXXXXXXXXXXXXXXXXX--XXXXXX-XXXXXXXXXXXXXXXXXXXXXXXXXX-XXXXXX-X-XXX---XXX-XXXXXX-XXXXXXXXXXXXXXXX-XXXXXXXXX|X-XXX
