--------------------------------------------------------------------------------------------------------------------------------------------------------------------------------------------------------
-----------------------o-B--------------o-To---------E--M------B----B-------------------------------o-o---M------o-------M---o-------B-----M-------M---------X------o----X---o-----------------X--------
-------------------o-o-----o-o----X-----o-|XEM-------M----------------B----E-o--o-----------o-----B--o--------B---oX-----------o------Xo----o-o--B-------------o---o-------o--------------M--o----------
-------------o----------------X-oo--Bo---E|-X-ooo--------X----?-o----B-----T----B---------?-o-------o-------------------------Bo-X---o--------M-M---B------------E-B---------------------X-ooE----o-----
---------------------oo----B-------o-----?|------o-ooo---o---B---o-----ooE-|----------o-----M-------o-o---Eo-o------E--o--o-o------X----X-------o---o-o-oo-T-----M-------o---------oo-o-o----?o---------
--------------------------------------o---|----Eo----oo------oo----------B-|------B-----------E------BTX--?---------B---T-----o-?------X-o--X--------?---Bo|-XE-------------------M---B-----------o-----
-----------?--B-------------?-----B-------|----B-----Eo---o--oE----oo------|-----E-o-o--Mo--EoT-------|--o------M----X--|---------------o--o---------X---o-|--X---------?-----------ooo-M--MX-----------
-----o----E---o--ooT-----MX--o---------Bo-|----------?----X---BX------X?---|B----X-----o----B-|-------|-o---X---------o-|-----Xo-Mo------------o-------o---|-------M-ooo--o--------T---o--------M------v
------M---B-----o--|o-----------------o---|-oME----M-oM------E--oX---------|o--B-X-----------o|------o|o-B--o-----oX--X-|Bo-----E-o------M-------E-M-------|E----B---o-o-MM--------|M--------M---T-----f
-----o-------------|-------------oB-------|---BE-----o---o---M--------o-T-E|-o----o-----------|--o----|-M-----X---To----|--o----T-oM---o---X-o---M-oE------|B---o-M---X----------M-|---o------X--|-----f
------o--E---------|--M----o-E--o--------E|oB--X-X--o-oo----------------|-B|-o---o------------|-o-E---|-o-------B-|-----|------o|E--o-----------?-M-X------|-X-o-------ME-----o--oo|o--oB---o-M--|-----f
-----o--oT--Mo--o--|---o-----X----o------X|-----X--o---?-o--X?----oX-X--|--|X-----------------|---T-X-|M--o-----o-|---?-|E---E-o|T-----Bo--------o-----o-o-|----o-------B----o-----|---o--oo---B-|-----f
-----B-o-|---------|----------BB--o----o--|----B---B-----o-o--------oo--|--|----X-------------M---|---|--o-----X-o|-o-o-|M---Bo-||B--o-------------o--?----|o-oo------o---X--oo----|-------o-----|-----f
-------o-|---------|--------o-------------|------------o---------------o|--|------o-----o--o------|---|------o----|---oo|-------||----o----o------------o-o|-----------------------|o------------|-----f
m-----o--|-o------E|--o--------oE-E-------|-E---ooE----o--------------E-|o-|--E--EE-----------EoEo|---|-EE----o---|-----|E-o----||o------EEE-----E---------|E---oo-o-------------E-|-----oo---E--|-----X
XX-X-XXXXX-X-X--XXXXXXX-XXXXXXXXX-X--X-X--|XXX--XXXXXXXXXXX-XXX-X---XXXXXXXXXXXX-XX-XXXXXXXXX-XXXXXXX-|-XXXXXXXXX-|--XXX|XXXXX-XXXX-X-XXXXXXX---XXXXXXXXXXXXXXXXXXXXXXXXXXXXXXXXXXXXXXXXXXXX-XX-XX-XXX-X
