--------------------------------------------------------------------------------------------------------------------------------------------------------------------------------------------------------
----------------------X------o--o-o-----------------------o--Bo-X---------oo-o---T-o-E------------------------------------------------------o-o------o-----X-X------o---oX---o--o----o----M----X--------
-----------------o--o----oo-o-------E-B----o---------Xo-o---------XE-----o--o-XBX|---X-------------BM--------o--o-o-X--o----o------------E-------------------------o---------B-------o-------o----------
---------------?---o-------X-To-----B-------B---------ME----oo----oM--M----------|-----o-----------o---------B---o----o--o-------X--E---oB---T-T------X----------X-B------------o------T-XoooE--B-------
------------X-o-E----o-------|---o---M-o-oB--B------o--X---EoX------------E-X----|--------------T--------------B------------------B-X-o-o----|-|B-------E----------------o-oX---------o|o----?o---------
---------o------M------------|--X--------------E-----X-----X-o-T---oo-----X--o---|----------Xo--|-------oE--------E----XT--T---B------o------|-|--------B----XE-------E----o---o-oEX--B|--X-------------
----------------------B------?--------o--E-----B-------o-------|-Mo--------------|-----o----o-X-|----B-BTM--------X--EMo|o-|---o------------o|-|-------o------X-------?-o--M------X---o|M--M----o-------
--------EXo------B-------o-----o-------oM?---o----o-o--o---E--X|--o----B-------o-|----------B---|o------|-o--o-o-----M--|--|-----M--------o--|o|-?-o--B-E----------M--Eo--o----o-----M-|----------o----v
------XoM-E------o----o---o------E----------------T------E-X---|--------M-M-XEo--|X-----o--o----|--o----|----ME---------|--|oo-B--------X----|o|--------B--o---oo-----B--MMo-----o-----|-----M---T-----f
----------M----o--------X-----o-EB---o------------|------Xo-Eo-|-?oB----X----M--o|--------------|-------|--oo-B-o-------|-o|-----------------|-|---o-------------X-----------E------B--|------X--|-----f
--------------B--?----o-------MMM-XX------o-------|-T-------M-B|--------o-------o|-------Bo-----|-------X-------------Bo|--|-o---E---o-------|-X--o----------X---------------Bo---o----|B-X---M--|-----f
---M---?-o------o---o--ooo---o--------------------|o|---B------|---------o------X|--------o-----|----X---------E--------|--|o----T--E--------|----M---X---E------o------o----o---------M---o---B-|-----f
-----T-oo---------oo?B-----------------X---oo--oo-|M|-o----X---|--B-----o--------M----o------B--|-o-?oo--------X-B-----o|--|-----|--BBX-----X|------------?---o--o------o-X-ooo------------o-----|-----f
-o---|------------------------o----------o--------|o|-------o--|--------oo---o-o-----o----------|-----------------o-----|--|---o-|-----------|------------------oo-----------o-------------------|-----f
m--o-|-------o-----------------E--Eo---o-o------E-|-|-o---o-E-o|------oo-------oE----EE---Eo-Eo-|--o-E-----o-----------E|--|-----|-o----o----|------------oo------Eo--------E---oo-------o--o-E--|o----X
XXXXXXXXX--X-XX---XXX-------XXXX-XXXXXXX-X----X-XXXXXXXX-XXXX-XXXXX---XXXXXX-X-XXX-XXXX-XXXXXXXXXXXXXXX-XX-XXX--XXXXXX-X-XXXXXXX-XXXXX--XXXXXX---XX--X-XXXXXXXXXXXXXX---XXXXXXX-XXXXXXXXXXXXXXX-XXXXXX-X
