--------------------------------------------------------------------------------------------------------------------------------------------------------------------------------------------------------
--------------------------------------o----B------Bo-B--o-Bo-------Bo?B------M------BX-------o--o----------oB-----o-------o------------o-B----o------------X----------------Eo--o-------o---o--X--------
--------------o------o------M-o----o---------M---E--Mo-o-o--------E---------o-M-------------B-Xo------------------------------X--------M---?-----------T--o--oE--------oo---MB----o--o-------oo---------
-----------------------------------E----o-------XX---o-B--------oEXE----X-----------------------------o--B--o------X-------B----oX----X-X---o----------|------M--E----------o---oE-----B-X--XE--B-------
----------o-o--o----X----o-B----X--X--X----o---o-------------o---B-X--------------M-------ME-----E----o------o-----o-o---------oo--X-----------MoE-----|E--------M-------o-o-----X-----o--o--?----------
----------o-o----B----------o----o---------oo-----------X---oB--------?-------o------------BB--o-M--X---oo----M---------T------------o----------ET-----|B----o--X----Xoo-o-oB--o--oX----M---------------
----------XBX--X-----------o------B--X--------o?X---TMEo---------------o-T---?--ooo-----------------o--------M--T-------|--M--------------oX----X|-----|----B------M---o---Mo-------B-o---------o-------
------------------o-------?-ooB----?------o----o-o--|-X---o------------oo|---o------o---B--o---o--B-----o-------|--B--B-|----o---M----M-------o-o|-o-o-|E----o-------------------X--o-------------o----v
------?o--------------E--------B-----o?--------o----|---------E--Xo-B----|-E--------To--o-oTM------------B?--o--|-------|-o-Eo--o------B-o----oB-|-----|BoEo-o-oEBoo-------o------o----------Mo--T-----f
----------o-----o-o---M--o----------o-------X---oo-o|---XXo-o-M----o-----XoX----X---|----?-|----oT-B--------oXEo|-----E-|---XE--M-XM-X---Bo------|-oo--|--B-o---X---o---BX---EX-----------o-o----|-----f
---------EXo-------------E---o---o----------------o-|-o------B------------oooo-o--o-|?-----X-----|E--------Bo-BB|---ooX-|----T---E-----oo------o-ME----M--------o----o-------B---o-----o---------|-----f
----E-X-oT-----o---------M-o---E--E-----oo--o-------|-Eo-o-------o-o---o-------B---M|---?--------XB------o----oX|-----B-|-oo-|---T------o------o?oM-B-------?X--------X?-----o---oB----B-------B-|-----f
----B--o-|o--------o-----oT--B-T--M-M--------M--oMo-|-X----------------o---Mo-----o-|----------Xo---o--o-o----o-|o----o-|--o-|oX-|--o-o---o----X-------o----------o----------o---B----X-o--o-----|-----f
-------oo|--------o---o---|----|---------------o-o--|o-----o----o---o-------o-------|-o-----o--------------o----|-------|----|---|---------------------o--------o--------o---o------o------------|-----f
m------E-|--o-o---------o-|---o|------o-o---o---oo--|---E-----o------E-EE-----------|--Eo-o---o------E-o---EEEo-|----o--|-o-E|---|---o-EE---------o----o---oo----o-----oo------oo--------o--E-o--|o----X
XXXXXXXXXX-XXXX--XX---XXX-X-X-X|XX-XXXX-X--XXX-XXXXXXXXXXX-X-XXXXXXXXXXXX--XXXX----XXXXXXXXXXXXXX--XXXXXXX--XXXXXXX--X----XXXXXXXX---X-XXXX-XXXXX-X-XXXXXX-XXXX-XXXXXXXXXXXXXX-XX--XXXXXXXX-XXX-XXXXX--X
