--------------------------------------------------------------------------------------------------------------------------------------------------------------------------------------------------------
--------------------------X-----------o---M------B---------------o----------oM------o-B-o---T-----X--o---X----oo---o-oM--------o---o--o-------o-o--------E----------------------------------X-----------
------------------------------o----B--o--o-o--M-----------o---o--X--?----o?-----------o---X-|-----o--T----M-------o----------o---o-------o---X-------o---?---------E--------------M--o---B--------------
----------------o----ooo--o--------------Bo---------------------o--o-------------B-o----X---|--------|-------B---o-----o----o--o------E--B-Mo------B---X------o----?o-----Bo--o----------o-----B--------
------------E----------Bo--E---------E------E-------o-----o-o------o--o--------------E----o-|-----o--|------------E---o----B----o-----X---oM-o-o--o-M------------E--------oo----------------------o-----
------------B----o-B-------?---o-o---T------M--X-----------X-------o---Mo-oo---X----o?-X---X|-Xo-X---|-o--o----BX-M--B--X------E--X-----------T---o-----oo-E-----X-------o---o-------oX-oo----M-?o------
--------X------------oB---?o---------|------o---------o---M-----oM--X-o---ooX------------B-o|-o-X----|o--o-----o----M------?---X--o-E------o--|----o----?-oM-----oB------------------Bo---oo---o--------
--------------X-B---oo-M------o---E--|---o-------Bo--B-----E--B----o-X----------B-----X-----|--M-----|E-----X------oo---o--B--------?---M-o-M-|------oE-o--o-o-o-------o---T---oo-o-E-------------M----v
--------------oo--------o------o--B--|o--o--------o-o---o--X------B-o--Too-MoE-----B-E-o----|--------|X-------E---o-------E-------------------|-------M--------X---XoE----o|---o----To-?------o---M----f
------o------o--o-----oE---o-----M---|----------o-------o---------o---B|--o--B---B--MBE-----|----B--o|-M--oB--T------X----X---------------o---|---oB-o--o-o----------?-----|-------X|---------B-o------f
------o-B-----X--------X---X---E-----|---o-------o--------------E-----o|B---------M---X-----|---X---o|---o----|--o---o-----o---o------------B-|----o--o-?--EB-o----------MM|----?---|X----Mo---o-------f
---B---oo------B---------o-----T---B-|oX-----M-------o-----E----MM-----|--X--o--B--T--------BX-------|-----BBXB--------TE--o-oE-E-o-----------B-------B----M----o----o-----|-------o|---E------B-------f
------o------o-----------------|--B--|---------------o--o-oM-----------|----o--oo--|o?---M----------o|---------o-o--B-o|X----TM-B---o-------------?-----------ooX--o--o----|-o-X--o-|o--BX---?-o--T----f
------o---------ooo-----o-o--o-|o--o-|-oo--oo-o------------o-----------|------o----|----------oo---o-|------o--o-------|-----|--------o--------oo------------o------o-----o|---o--o-|--------oo--o|----f
mE--E-----------E---E-----o----|----o|-EE-o-o--o--------o------E-Eo--oE|-E--------o|--E-----E---o----|------o-E---o----|-----|oo---E-o----o---E--o----o--oo--oEo------o----|Eo-o----|-------o-----|----X
XXXXXXX--X-XX-XXXXX-XXX-XXXXXXXXX--XXX-XX-XXXXXX--XX----XXXXXXXX-XXXXXXXXXXXXXXXXXXXXXX--X-XXXXXXXXXXXXXXXXXXXXXXXXXXXXX----XXXX--XXXXXXXXXXXXXXXXXXX-XX-XX--XXXXX--X-XXXXXXXXXXXXXXX-XX-X-XXXXXXX|X-XXX
