--------------------------------------------------------------------------------------------------------------------------------------------------------------------------------------------------------
----------------X--o----o-B-----X-----o---o--------o---M---X---X-----------------Eo?------X--------o-oo---o---M---------o---------------X-?---o------o---o--o---------oo---------------o---E---X--------
--------------------------o-E-Bo-B---T----------------E------------------o---M--oX-------------o--B--M------------o-----Eo----------METE-------XX-----X-----Xo-----------o--------o--o----MX-o----------
---------M----------o-------X--------|o-Eo--o---------X--B---E---------o------M--------------T-X-?----o--B---o-M----M-E-T----E--o----B|B--------o----------M---B----B--------------------X--oE--B-------
----------o------o-X---?o--o-----o-o-|--M--o--------?T-----E-X------------------o-----oXo---o|-------------X----------?-|o-o-?-oB-X---|--X-------Eo-----E--o---o-B--oM---E---------oM-ooo----?o---------
----------o--B----M----------------XoBo-B--B---------|o----X----o-----E--B---?-B---oM---M----|-------E--o---------------|-------------B-Eo-E-----T----X-B----o-E---------X------o-o?--B-----------------
----------X---------B-o-------o-------X-----ooo---?--|-o----oo---X----T-------------o--------|--M-B-oB-B--------o-------|--o------------X--M----M|-----o-------XE---X----o------------ooM-------o-------
--------------E-----------oo--o--o----oT---o-----o---|---o------------|---o--------o--X------|-----E--------X?E-ooM----MB--oB-o--B---B------o-o--|ooo---E----o-oT----B-o--------B-----------------o----v
------M----B-M?------------B----oX-----|--o---oM--o--|E-Xo-----------M|---oE-B----X-X--oB----|-----X----o-----Mo----?---o-----M-----T------oX-o--|------B----o--|B-------EX-------oo---------M---T-----f
----------o----------------------------|----X--------X?-o-o---o-------|----X--------------o-o|--------?-E---------------o----o-X-o--|-MBo--------|-o------------|--------?-o-o-o----o---------X--|-----f
------o--oX-B---oo-o------B-o----------|-M------o---B---o-o--o------o-|-------oMEBo-o--o--ooo|-BoB--o---B-XX?-----X-oM----------o---|---o---o---XM--------------|-o-E--Xo--o--XB----o---B-----M--|-----f
-----------XooT----o--o----E---oo-B----|--oo---o----------------------|--o---To-X------------|--o----Eo-------------T----o------M--E|----o-------o-----------X--|M--M--------o--o-B-o-----o----B-|-----f
--------o-o--X|-M-X--X-----X---o------o|X---------X--------------B----|-o----BX-----------o--|-------M--------------|-oo------B-o--B|o----X-B--X----------------M-------oo--Xo------M------o-----|-----f
-----------o--|----------o--o----------|--o---o---oo----------oo------|-------o--------------|--------o-----------o-|------o--------|--------------------------o------o---------o----------------|-----f
m-----o-------|o-----o----------o------|E---oEo-o----o---oE-----------|------------o--o------|--oo---------o--------|-oo--oo--E---E-|E--------------------o----o--ooo--------oo-EE-------oo-o-E--|o----X
X--X-XXXXX-XXXXXXXX-XX---XXXX-X-XXX-XX-|XXXXXXXXXXXXXXXXXXXXXXXXXXXXXX|--XXXX-X---XXX-X-XX---XXXXXX-XXX-XXXXX----XXXXXXXXXXXXXXXXXXXXXXXXXXXXXX-----XXXXXXXXXXXXXXXXXXX-----XXXXXX-XXXXXXXX-XXX-XXXXX-XX
