--------------------------------------------------------------------------------------------------------------------------------------------------------------------------------------------------------
----------------?-o-------------o-o--------o-------o--o------M--------B-o------o--------o--o---B--X-E------o-------o----------o-o---B--------------------E---------o-----------o-----------X------------
---------------------X---B----------o--E---o--------Xo---------o---------o---B-B--------------------B-o---o-E-------?oo--------------X-o-o-------o------X?--------o-----------o-------------------------
------------------------X---oo---------XE------X---o-----o---o-----------oXE-------X----X-B---?-------o--X-?M--o--oB-B----------------?--E-----M----------Mo---o-o---------o----o---------E-------------
--------------------o------E--oE?o----B-?--------oB--o------o-X--o-?---M---Bo---------X-----X-----------------------------X---o--X------XB-----------X------o-------------oo--o---o-------X-------o-----
-----------B---------B--o--B---B--X-----B-o----o--------o-X----o----o-----X-X-Eo-----------oo-----o-------o----Eo-------o--X-------TB-----o-----o----o---o-o------M------o---?X---o-----o------o?o------
-----------o----?oX----------o-o-o--------Bo-----o------o--oo--ooo---------o--Mo-o-------------o--------oEM---MB-Bo-----o----------|--------Eo----o---o-------B--o------------o---o---------------------
-------------o----oo------------?--M-B------E------X----M-o----------M-o---------o---o-------------o-----X----o--o-------o---------|---oo--oB---o------oo---Eo-oo------o---T---X----E----oooX-----M----v
---------o--------o-o---XX------oo----------B-----oo-------X-X----B---oo?-----oo----B-Xo-------------oTXM?E---o-o-o--------------E-|o----oo------------o----X------M-E-----|----o-o-T--?---X-B----M----f
----o---X-------------o-o---o-----------o-----------------To---X----------o--------------oo--M-B-----?|---M--o--------T-o-----B--B-|-----M--o--------Eo-------X-M--oo?-----|---o---X|----------Xo------f
----o----------o----------oo-o-----------------o-----oE---|-----------------o-------oo----------o--o--|-----o----o----|--B-o-o----E|---------------o-To----oo------------M-|------o-|o------X--o-------f
---E-B-o------M---X-----o---------X------o--o-----o---Bo--|-o---------oo------oo--o----X-----------o--|---------o---B-|-----------BX------B----------|------B----oo--o-----|-------o|-E-EoM------------f
---B-----o----------------------o?--X-------------------XBM--oB----To-------BXBX----------oT--T---B---|o------oo-M-B--|-------o-Mo------------------o|--o------?-----------|--------|-T-B---------T----f
-o---------o--o-------o----o---o----o-------------------o----------|o-----------------o-o-o|--|---o---|------o-oo-o--o|---o---------o---------------o|--o---oo---o---------|--o-----|-|----------o|----f
m-----Eoo---------o--o-o---oo---------o------o-E---EE-----oE--o----|-------oooo--E--oo--E--|--|----o--|-----o--o------|o----------o--E------o----E---|-Eoo--oo----o--------|Eo------|-|-----------|----X
XX-X--XXX-XXXXXXXXXXXXXXXXXXXXXXXXXXXXXXXXXXXXXXX-XXXX--X-XX-XXXXX-XX-X---XXXXX--XX-XXXXXXXX-XXXX-XX--|---XXXXXXXXXX-XXXXXXXXXXXXXX-XX---XXXXXX-XXXXXXXXXXXXXXXXXXX-X--XXXXXXXXX-X-XXXXX--XXXXXXXX|X-XXX
