--------------------------------------------------------------------------------------------------------------------------------------------------------------------------------------------------------
---------------------------X------B-----X----------X-o--X------------o--------------------M-B-o-----------X--------E-----Mo--------------E-------oM--------X-Xo----------X-----------oo---M----X--------
--------------------Mo------X---o----------E-------o----------o--------o-----?M----------------oX-------XX-------o-B-X--------X----------T-?------o-E-X---o---X--------------------------o---oo---------
-----------------B---------------X---o-----B-oX-------B----------BE---------------o--B--?-----E-o--B--------Xo-------------B-X-----B-----|--o-------T------------------o-------o-----B----o-oE--B-------
------------o--------------oo------?--------oM-o--------o---------B---------o------o---E-o----B----o-o-B------o-----o------------------Bo|-----M----|---E-----o---------Bo-o---o--------o----?----------
------------o------------o--------?-oE-o--M-----B--T---------oB--Eo--------E--------o--X---o-o--------------------------T--------o-------|--------?-|---B----X---o--------Eo------EX-----oX-------------
--------B---X-----------X-o-MMX---o--T-----To--?---|-E-----------M-----BB--X-o----oBB-----B--------X-----------X--o-----|--M-------o-----|XX--------|X-o-----------Xo-----BM------X-BE--M-------o-------
---------------o--o-o----B-Bo--------|---E-|-M-oo--|-ME-X----------o--------o----o--------------------o---o--?-----o--o-|---------------E|----------T---E---------------o-------E---oB-o----------o----v
--------------BM----o-?-------o------|---?-|---o---|?-Bo-------------------------MB-----T-o------?------T-------?M---XX-|Bo--E--X---?---B|B----B---o|E--B-Eo---oo-----oo-M-o----Xo-------o---Mo--T-----f
--------------------X----------------|-----|--B----|--------------------E--T-------B----|--------o---X--|------o--------|----X----B------|----------|BX---B-o----------E-----M--------oo-M-------|-----f
----o---------------------------o-o--|--X--|----o--|-B-o--o--M----o--o--TX-|-----oE-----|---------------|o-E------------|----o-----o-o--o|-----o----|--------X------M--To-o-M-o---o----oB-X------|-----f
----B--o-------?-B-----T-------------|----X|-E-----|----o?-------oo-----|--|oo-o--X--o--|-oB-o--o--X---M|ooM---------X?-|Eoo----o-----oX-|-----oX-o-B------------------|E----o--------Bo-------B-|-----f
-------o--------------M|X-oo--------o|--o--|-?---oo|--------o--Xo-ooXo-X|o-|----o--o----|--o------------|T--X--o-B-M--o-|M-o--o--o-o-B---|-----X----o------------o-----|M-M-ooo--X---o-----------|-----f
-------o---------------|-------o-----|-----|--oo-o-|----o---------------|--|------------|------------o--||-o------oo--o-|---------o------|----------o-----------o--o---|-------o----o----o-------|-----f
m--o------E-o--o-EE-E--|o------Eo----|-----|--E--o-|--------------oo----|--|-----o--oo--|---o--------o--||-oE-----oo-o--|Eo------o-----o-|-------o-E-------oE-----E----|--------------o--o--o-o--|o----X
XX-XXXXX-XX-XXXXXXXXX-XXX-----XXX-----X-XX-|--XXXXX|XX--XXXXX--XXXXXX-XXXXX|-XXXXXXXXXXXXXX-X-XX-XX-XXX-XX-XX--XX-XXXXXX|XXXX-XXXXX-XXXXXX--XX-X-XXXX-XXXX-XXX-XXXXXX--XXXXXX-XXXXXXXXXXXXXXXXX-XXXXX--X
