--------------------------------------------------------------------------------------------------------------------------------------------------------------------------------------------------------
--------------------o-------o---X--------o-----X------X-EoB------o------------X----?---------o---------o----B------oM-o---------X-E-------------------o---------------------------------o--X------------
--------------------X--o--------o--o----X----M----------B----M-----X----------------o---------------oB------o-E---o--o--X---------X--------B---------------o-------------o--------M-----X---o-----------
-------------X---------------o-Xo---o-------o------T----------------o--o-X-----oo?-------Bo---o-BE--------B---M----BoB-------------o--?--X-----?Eo---X---Boo---o----o--o-o-oo---o-----------------------
-------B---------E----o--------------o---o--Mo-o---|------------o----E--------B--------Xo-E--o---To------o----------E--o--X-BoXTB-o--------E----B-----X-------------o-----o?--?-------------------o-----
-------o---------M-M-------o--------MX-M--EM-------|-----B-----?-o--TMo------E--------oo--To-----|E--o--?B--B---o-o-X----------|o--M-------X----o-------------o----B----B--o----------X--------o?o------
-----------X--oo--------Bo-o----Mo-o--o---X----X--X|---------o--o---|-X-M----X----o?----Eo|------|X---XE-------M---------------|--o--o--o---Eo--------o-------T--X------o-------------o-M-o-------------
------------o--------o-o---X------o--oo---o----o-X-|-o----o-------B-|o-o-----o----------Xo|BE----|-oM--T--o--M---------------o-|-------o----B---o-------o---M-|--oo----E----X--X--o------o-oo-----M----v
-------XM-----E-E----E-------X---B-o----M---o----o-|------EM--------|o---o------o---------|-X----|---M-|------o-o-o------------|--o------oX------o---X--X-----|--o----TX------T-?----M-?---X------M----f
--------oo----M-T----B----o--o--------E------E-----|Mo----T--B------|--E-M-----o----------|--?---|-----|-?---------------o-o-E-|-------o----o------E----------|-------|-B-----|-o--XTo---------Xo------f
---o-----B-----X|---------B-----------MX-----Bo----|--o--o|-B----?--|--?-----E-------M----|------|----B|o--E--o--------o---o-?-|---M-E---o-o-------M----------|-------|-o---o-|-----|-----M----o-------f
---T---o--o-----|-oX---o--o--------------oB--o--Eo-|--o---|-o-------|?X------X---B--------|--o-X-|-----|B-MB---Bo-B---B--o-E---|-o---B--o--------------o---E-B|---o---|------o|B---o|o---o-------------f
---|-o--o------o|---B-B-B--o------------?-------M-B|------|----?B-o-|o---o--X-o-----B-----|T-----|--o--|-----------B-----T-Bo-o|o----------------oT-o----o-T--|o----o-|---?---|---o-|---o----?----T----f
---|-----------o|--------o--o----o-----------------|------|-----o---|-o--------------o--o-||-ooo-|-----|--------o----o--o|o----|--o-----o-------o-|-o-o----|--|-------|-ooo---|oo-o-|--------o---o|----f
mE-|------o----E|---------o----o-----------E---o--o|oo---o|E----o-o-|-----o-o-----o-------||---o-|---E-|-----------------|----o|-o-------E--o-----|E-------|--|-E-Eo--|------o|o----|-------------|----X
XX-XX-X---XXXX-X|-X--X-XXXXXX-XXXX--XXX----X-XXXXXXXXXXX-XXXXX--XXXXXX-XXXX-XXXXXXX--XXXXXXXXXXXX|---XX|--X-XXX-XXXX-X--XXXX-XXXXXXXX--XXX-XXXX-XXXXXXXX---|-XXXXXXXXXXXXXXXXXXXXXXXXXXX---XXXXXXX|X-XXX
