--------------------------------------------------------------------------------------------------------------------------------------------------------------------------------------------------------
-----------------o--------------------M-X---X-------------------oo-------------o----------XBo-----o---oM---o--o-------o-------o-o---B------------------o--X-o----o---o---------o-----------X------------
-------------------------o-----------o--o------------------o-----------------------o----------------o-----X-o-------?o---------------X-----------o-oo-------o----M------o-o---o---M---------------------
------------------------o----------E---------------o-oX-----T---------------o----------------o-------M-----E-oX---o--B-------------------X-----ME---------oM?-----------------------------E-------------
----------------o--------Bo----M-B-X--------o-o--BB--o---B--|-B------Boo--o-B-oo-------o--------B--Mo--ooM-B---M----------X---o--X----XEX-------B-------o-----XBo-------------o-----------X-------o-----
-----------------?------------------oE-----o--X----oo--X----|---o-------------------?------------T----B---o---o-o-------o--X--------B--B--o-----o--MoM--o--E------o-E---------X-------X-o------o?o------
--------B-----------B------E---------XE--oo----o--o---o-o---|---------o---o--B-o-B---B-B-B---oM--|o------o-------Bo-----o-------------------Eo----oo--o----X-o----o-M-------o-o-------o-----------------
------------B--------------M----------Mo-------------------T|-o----o-M----B-----------X-----oo---|-----M---------o-o-----B---B----------o--oB---o---------o------X-------------Xo-o-o----oooX-----M----v
-----------o-E-o----B--B----X-o-B--------E--------o---E----||-----B----o-------o----M---o-oM-X---|--B----o---oo-o-o--------------E-oo----oo--------o----------------o-------o----------?---X------M----f
-------------X-o----o--o-o------o---?----M------X---o-X----||---------X-------M------Boo---o-----|o-X--o-o----o---------o-----B--B----------o------X-o---------X-----o----o--o-o---X-----------Xo------f
--------o--------o--o-o--B-------XB--o---------------------||-o------------------M--------M------|o------Bo------o-----o---o------E---X--o-----------X--------B--------?-o------?----o------X--o-------f
--------EM-----------?-X--Xo---------o-----o---o-o-------EE||------------o--E--M----oo-------o---|----M-o-------o---B-B-----------B-------B---------------M-------?---------o------o----EoM------------f
--o-----Xo-X--------------o--o----------T-o-----M------o-BB||----X-o-B-X---T?--------o---M-------|M-----Bo-------M------------o-Mo----o------------------------?-TX--M--o---------o-----B----?----T----f
-----o--------------o------o------------|--------------o---||--------------|---------o-----------|-------o-----oo-o--o----o---------o-----------o--------o-o-o---|--------o---o---o----------o---o|----f
mo----------o----E-------o--o-----------|---o---oo-Eo---E--||--------------|-E--EE---------------|--o-E---------------------------o--E---E--o----E----------E----|o-------o--E--------------------|----X
XXXXXX-X-XXXXX--XXXXXXXXXXXXXXX-XX-X---X|--XXX--XXXXXXXXXX-XXX---X-XXXXXXX-|-XXXXX-XXXXXXXXXXX-X-XXXXXXXXXXXXXXXXXXX-X-XXXXXXXXXXXXXXXXX-XXXXXX-XXXX---XXXXXXXXXXXXX-----XX--XXXXXXXXXXX--XXXXXXXX|X-XXX
