--------------------------------------------------------------------------------------------------------------------------------------------------------------------------------------------------------
--------------------o-------------oo-M----T------o------X------Bo--?----o--o-----------o---------EB---o-----E-------------oB-----?------oB?---o--oo--o------------------------------------ME---X--------
-----------X-?------B-----ooB-XBMB--B-----|-EM-------------------Bo-------o-o-------o--X---X-----M------X---X--o-o-------------M------X--------X--o-oo--------EM---------------------------X-o----------
-------------------o-----o--o------E-----o|-X-oo---E-------E-o----E-----o--o-B-----X-B-------------------ooBoo---------M------B----o--------o------X--oo----oBT-------B--T-----o----o----Xo-oE--B-------
----------o--------o-------oo--o--XX----MM|--------Xo------BE-----?--M----------------o-o------------o---o----o---X---M--------------------B------o-----------|----------|o-M--o------o-o----?o---------
--------ME-----?--------?----------X-B----|----E---------X--B----o-B-----E---o---oBoo--oM----Xo----------------o------o-------o-?o-----Eo----oo----o----Mo----|-o----XE--|-------o-X--B---X-------------
---------BE------X---o---BM-------oo------|----Bo-?---------o----o--E-o--X-------o-X-----BE------B--------MM---------o---------------o-X------?---o-oX-------B|o--B---BE-|----E-o----oo-M---X---o-------
--------o-Bo---oBoM---E-o------E--o---o--o|-----------------o--M----M-----oo--M-------X---M-------T------M---?-o--?o--X--o-B--X---o---------------T-----------|-oX-----B-|o-MBM--------o----------o----v
-------o-------?----o-B--------B----B-----T-oME---------------o--o---o--Eo-------B------B-----E-X-|-----T--------M----o---o--o--E-o------o------E-|X--o-------|oE--------|E-o----oo----------M---T-----f
-----?---o--o--o-----------o----o-------oE|---BE---------B-o---o-o--o--oM---o---o-o--o--------X---|--Xo-|------Xo-------o---X---T-o------B----M-X-|-E------M--|-?--------|X-------X----o------X--|-----f
--------?----------------E-o----o--------B|-B--X--X-o---B------E----------o--------oo---------M---|---E-|B------o------------o--|---oo------------|-B--------o|-----E-oE-|----------X--oB-X-o-M--|-----f
---------o-----------B---BXB--o------XT---|-----------X-------XBo-oM-E----B-oB-----o-X-------?----|---X-|--TB-----E--B---oo-----|M-----E------o---|--?-----o--|-----X--Mo|-------------o-------B-|-----f
---M---o------o---------M--o----------|---|o---B-o------oo------o----Mo------------------?--------|-----|--|-----BX-----------o-|-B----M--X----X--|----M------|----X-o---|----------o------o-----|-----f
------oo--o-----oo--------------------|---|-------------------oo--o---------------o-o-----------oo|--o--|-o|--------------------|-----o-----------|--------oo-|--oo--o---|----oo-----------------|-----f
m----ooE-o-----------E-----o-------o--|---|-E------o----Eo---E-o--o------o--------EE--oo-oo-------|-Eo--|--|o---E-----o---o-----|-o----------E----|------o---E|---E----o-|-------o-------o----E--|o----X
XX---XXXXXXXXXXXXXXX-X----XXX------XXX|--XXXXX---XXXXXXXXXX-XXXXXXXXXX--XX--XXXX--XXXXXXXXX-----XXXXXX-XX-XXX--XX-XXXXXXXXXX---XXXX-XXXX-XX-XXX-X-XX---XXXXXXXXXXXXXXXXXX|----XXXX-XXXXXXXX--XX-XXXXX--X
