--------------------------------------------------------------------------------------------------------------------------------------------------------------------------------------------------------
-----------------B-o----------------------o--------------o--------------------------oT-----E--X--E-----------------B--------------B-----------o-oo-----------------X------------------------------------
-----------o-B--o-----------------o---E------------------------------o-------o-------|-----B---EMM-------o--B--------------------X-----------------B-o-E-M-------------E----------M------o--o-----------
-------------------------o------o-oo--M---oM-Xo--o----XX-M------M----E----XM-o-------|--o----o-Bo-o----B----oB------------o-----?------oBoo----o-EX---oB---o--To----o--T---oo-B----------E-----B--------
-----------o-E--o--T-----------------E------?----o---------oB--------To------B-------|---M--------------o?---------oo-------o-X--------------o-o-M------------|--E-----|--oo-------------M--------o-----
------B------X-----|--------o---B--o-X--oo----o-o--B-X------------o--|-oo-X---B------|o---B---o---o----oo--o--E-o-E------o------------X---B--X----------------|--X-----|-----o--------X-oo----M-?o------
-----------?-----o-|---o-X-B---X------o------o--------o----o----E----?-------o-------|-----B---oB-o--X--------BM-BM---------o--o---E?----B-XE----o-E----------|--oBB---|--------------o---o----o--------
-----------------B-|---------------Bo-B-oE--B-M-o-o-X---Xo-E----Xo-------------------|----------o--------E-o-----o-------o---o-----B--------B------B-o--E-EM-o|o------?|---T---oo-o-E-------o-----M----v
-----------o-------|---o---------E-o--oo-X--------o--TE----TB-----o-o-------E--------|o-oo-------M-?-----M-Xo---o-X-o------------B---E----oo----E--o----X-X---X-----oE-|---|---o----TM-?------o---M----f
--------o------B-E-|------o-o----Bo------o?----------|X--X-|-X------------o-X--MT-B-B|--M---o-----------oE---------o-To------E-----o-M------o---X----o----------E----?-|-o-|--o----X|o--------B-o------f
-----------o-----X-|-----X--o--o----E--------------o-|-----|-----------------o--|----XM---B-o--B---------X-E-----o---|-------B--------Eo-------o---T--------B---M------|---|----?---|-----M----o-------f
---X--o--oo----o---|-------------o--B-----o---X------|-----|------X-o?o----o----|ME----X-o-o------------EooB-T--o----|--------------o-B-X-o--------|---E-------------o-|---|-------o|o--E--o---B-------f
----o---B--M-------|M---B----M-M---o-----X-----------|-----|--o-----------------|-B-----M----Mo--Xo-----B----|---M---|-XB-B-ooo-----X--------ooo---|---X-------?-------B---|--BX--o-|---B----?-o--T----f
-------------------|--o---------------o---o----o-o---|-----|---o----o-----------|------------------o----o----|--o---o|-----o-o----------o------o--o|---------o------o------|---o--o-|------o-oo--o|----f
m---o--------------|EE---Eo---Eo------o---o-oo-E-----|-----|---o-----E--E-------|-----------E--ooE--------o--|o------|---Eo---o---------o--oo------|-----o---o-----o--E----|o-Eo----|------o------|----X
X-XXX-XXXX--X-----XXXXX-XXX-XXXX---XXXXXXXXXXXXXXXXXXXXXXXXX---XXXXXXXX-XXX-XXXXXXXX-X----XXX--XXXXXXXXXXXXXXXX-XX-XXXXXXXXXXXX-XXXXXXXXXXXXX-XXXXXX---XXX-X-X-X-X-XX-X-XXXXXXXXXXXXXXXX-X-XXXXXXX|X-XXX
