--------------------------------------------------------------------------------------------------------------------------------------------------------------------------------------------------------
---------------------------B----X----------------E------E-----o--o-----o----------------ooE------B----M----o-----B----M---X-------X-E----X-------o---------X--?---X-o----X-----------o----M----X--------
-----------------------o-----Xo--------B---o-oo--B------?---------B-o---o---oE--oX--------X----------o---X-----------X-oE---ToE-----?-XM---?-------oo-----o---oo---o-----------------o-------oo---------
-----------------X-Xo-------------------o--------------X----o---E------------M-BB--X---o--o-B-E----ooo--o----o----------X---|-Xoo-------------o-------X----------E-B-----------o---------Xo-oE--B-------
---------------o------X------o----------------XB---o---o-------oB-----M-o-o-X----o--Eo-E--ooM-M---------?o-------B--o-------|-----oo----------------o-----M--o---Mo---B--o-o---o--------o----?----------
-----------------------o--B-------E---------------o-----o---o-------BX----------o---B--T---B-B------o-----M-------?---o--T-o|-ooX------B-------B--o-----------o------------o-----oEX------X-------------
-------------------------o--------B---T------o---TM---o-----Mo----------o-------X----o-|--------ooE-------o--------X----o|o-|T----------X--X------XM---o-------------o-----ME---o-X-B-o-M-------o-------
----------B---E-o-----?-?--------?---o|X---------|o---o---o------------oX----B---------|-o--M-----Bo--B--X--X?-----------|--?|----?o----------------ooM------------M---o----B-------oM-o----------o----v
----------o--o?---E----o-o--o---M---o-|-o--o-----|---XM--E-o-o---oo----M----X--X-------|----------------o--------o--oXo--|-o-|o----X------------E--------o-oE----B----X--M-o-----o-----------Mo--T-----f
-----------E---oX-X-------oM-o---oM--X|---o?-o---X-------X--o-------------o--------o---|---o--------------o-----oB-------|---|----o--E--?-----o-X---------o-BXE-o-B--------------------o---------|-----f
--------M--X-------oE---------------E-|o---------------oo--------------------TE-B--E---|----oo--------E-----?---o--------|---|-?-----?o-------BM--E-------o---Xo--------o----Bo---o----oB-X------|-----f
-----------o--T-----X-o----o--B-B---X-|--Xo-----------M-----o------o------o--XM----M---|---E----------?--------------XoT-|X--|---?o------?--------X---o---------o-o-----o--------------o-------B-|-----f
--------------|-B-o--X----o-o----o-X--|-----M----------------------o----B--------B----oB---X-----oo---o---M------------|-|---|-----M---B--------------T-----o--o-----oT-------o-------X----------|-----f
------o-------|-----------------o--o--|---o-----o-----------o--------o---o--------o--------o--oo------o--oo---o--------|o|---|------------------------|---------------|--------o----o------------|-----f
m-o----oo---E-|Eo---EoE---------------|o-oE---------o---------o-E-E-------o---E-o---E-----E-o-oE--E--o--ooo-----E----oo|-|EE-|-----E------E-o--o------|-o--oEo--oo-o--|----------o-------o--o-o--|o----X
XXXX-XXXX-X-XXXXX-X-XXXXX------XXXXXXXXXXXX-----X---X--XXX--XXXXX-X-XX--XXXX--X-X-XXXX--XXXXXXXXX-XXXXXXXXX-X-XXXXXXXXXXXXXXXXXXXXXX----XXX-XXXXX-XXXXXXXXXXXXXXXXXXX-|-XXXX--XXXXXXXXXXXXXXXXX-XXXXX--X
