--------------------------------------------------------------------------------------------------------------------------------------------------------------------------------------------------------
--------------E---E----?--------------o----------------------o----X-o------oo--------o--------M--oo-----------------o--------M--XE------------------------------------B-------o------B-----XX-----------
-----------o--X---X--------------o-------X------EE-------------X?---o----o-----E-----o-----------o-----?--------ooE-----XM-------X------------------------------------------M-o---M---------------------
-----------------o-o-M---------------------Xo-E-BXT--E-o---B------E------oB----X----oo-----X-oo----------o----E-T-B---B------------o-----X------o--B--o-------oM----o--------------------------B--------
-----------------o---oo---oTM-o---?--------oo-Xo--|--B-o-----XE---T------------------T-----o------oo----------T-|---E-----X---X-B-----Xo-------o-----------------E----o---o-----------------------o-----
-----------MBo------B------|-X---oo----E---o---X--|------o-o-oB---|o-------------EB--|-------X-----o-------o-o|-|o--XT----------o-?M--------------------o--E---o-X-----------?--------X-o-------?o------
--------B----Xo--------EM--|------o----B----------|---------B-----|------o-B----oT-?-|-------o---B-X----B?-o--|-|--o-|X------?-o-oo--o-------o----oo----?o-M-----oB---B-------X-------o---o----o--------
---------oo------------?-X-|-o----o-----M---o-?---|--------o--o---|---------o---?|---|-o-------o--------o--o--|B|-B--|-o----------------B--o------------o-Eo-o--o------o------ooo-o-E----o-o------M----v
-------------------B-------|----o---X--o-o---X----|o----o-o--B-oE-BXXX-----------|--E|------o-E---o-----------|-|-o--|o-------------o--T----------o-------X---------oE---------o----T--?---X------M----f
---------o----oM?---------o|-o-E-------------o----M---oo---Xo-ooB-o------o------oM--?|--------X--B--------E--o|-|----|-o---o-----o-----|o-T--------B----o------TM--M-?---o---------X|X----------o------f
----------o-X-----X-------oT---Bo---E----o---o---M------B------Eo--o------X-----M----|------------------ooB---|-|-oB-|-----oX----X-M-EX|-X|--------o----?--EB-o|----------------?---|o----M----o-------f
----------M--oo-o--o-----o-|---o-oo-B---o-o---E---oE-----o--o--B----o-----o-BM-----o-|----------------------oo|B|o---|---o-Eo--------B-|E-|-X----o---o-----M---|-----o-------------o|---Eo-----B-------f
----X--------M-------?o--oM|---ooX-----------oMM---M-----B---------------Mo--oB------|o----------------o---X--X-|-T--|-----B--o-o-----o|B-|------o------------o|------o----o---X--o-|---B----?-o--T----f
-----------o-----------o---|------------------------o-------o-------------o---o-o-o--|-----o---------oo-o-o-----|o|--|--o-o-------o----|--|----o-------------o-|----o------oo--o--o-|--------o---o|----f
m---o------------------o-E-|-----E----o--o-----o--------o--E-o-----o-o-------EE-----E|-------o-----Eo--oo-------|-|--|-------Eo--o-----|--|------------------oE|------o-----oo-o----|-------o-----|----X
XXXXXXXXXXXX---XX--X-XXXXXXX-XXXXXXXXXXX-X--XXXXX-X-XXX-XXXXXXXXXXXXXXXXXXXX-XXXX-X--X-XXX-XXXXXXXXXXXXXXXXXX---XXXXXXXXXXXXXXX-XXXXX-XXX-XX-XXXXXXX-X---X---XXXXX--X-XXXXXXXXXXXXXXXXXX---XXXXXXX|X-XXX
