--------------------------------------------------------------------------------------------------------------------------------------------------------------------------------------------------------
-----------------o--------------------------X----B-o------oE--X-----o---------oE----X--------o--M----o---X----oo---o-oM---oE----------o-------o-o--------E---------------------------------XX-----------
---------------------------------M--------------------o----M---------oo-X-T---T?----o-?----X-----X-B-T----M-------o--------B----o--------o---X---o---o---?---------E--------------M--o---B--------------
-----------M-------------B----o-o----B-B-----X------o--Too---X--o-o-ME----|---|-------o---o----------|-----------o-----o--------?-----E--B-Mo----X-BT--X------o----?o-----Bo--o----------o-----B--------
------------o--------------E-B---o--------X-o--o------o|-oo----------T--o-|-Bo|---B-------o-B-----oo-|------------E---o--M-o----------X---oM-o-o--o-|------------E--------oo----------------------o-----
------------?----?-X-M-----B----BB-----o-----------oB--|-----------T-|-oo-|---|-E-------o---o----X-?-|-o--o----BX-M--B-----------X---E--------T---o-|---oo-E-----X-------o---o-------oX-oo------?o------
--------------------------------------M------o----o--o-|--o--o-o---|-?----|---|-X-o--M---oX----oo----|o--o-----o----M-------?---o-B--X-----o--|--o-o|---?--M-----oB------------------Bo---o----o--------
---------------T------------------T--o-----------B----oB-----o-XX--|--E---B---|--------E----o---o----|E-----X------oo-------------------M-o-M-|-----|oE-o-Eo-o-o-------o---T---oo-o-E------o------M----v
------?------X-|----X-E--o----o---|------o---------T--------o------|--X-M-----|--------B----o------B-|X-------E---o------o---------o----------|-----|-M---X----X---XoE----o|---o----To-?---X--E---M----f
----o-----o--X-|------M----o---o--|----------------|--------------B|-----oo---|oB---o----------o----M|-M--oB--T------X---------o----o-----o---|---oB|o--o------------?-----|-------X|---------?-o------f
----o----------|-o----B-----------|-ooo---E------o-|--o-o---o------|---------o|-o--------o-E-M---oo--|---o----|--o---o--X-------------------B-|----o|-o-?--EB-o----------MM|----?---|X----M----o-------f
-------o-E-T--X|----oEo--------o--|---B---X----o---|o---o--o-----B-|E?--------|--M---------?------o-o|-----BB-B--------T-?--------------------B-----|-B----M----o----o-----|-------o|---E------B-------f
-----o--oX-|o--|-----X--B---------|---o----B---B--o|-?-------------|M----B----|B--o-------X-T----B---|---------o-o--B-o|----M--?B-o-o-------------?-|---------ooX--o--o----|-o-X--o-|o--BX---?-o--T----f
-----------|---|-------o----------|----------------|---------------|----oo----|-------------|----o--o|------o--o-------|--------------o--------oo---|--------o------o-----o|---o--o-|--------o---o|----f
mE----EE---|---|oE--------o-------|-o-------oo-----|-----o--o---oo-|-E--E-oE--|o------------|-E--o---|------o-E---o----|--E-o-------------o---E--o--|-o--o---oEo------o----|Eo-o----|-------o-----|----X
XX----XXXXXXX-XXXXXX-XXXXXXXXXXX-XXXXX--XXX-XXX-X-XX---XXXXXXXXXXXX|-X--XXXXXXXXXX-X-X--XXX-XXXX-XX-XXXXXXXXXXXXXXXXXXXXXXXXXXXXX--XXXXXXXXXXXXXXXXXX-XX-X---XXXXX--X-XXXXXXXXXXXXXXX-XX-X-XXXXXXX|X-XXX
