--------------------------------------------------------------------------------------------------------------------------------------------------------------------------------------------------------
---------------------o-B------------o-o------E-----o---E--------o----B-----------------E-o---B----------B--------B-X-o---------------o--oB?---o--BM-oo-----X-X?----------X---o-------o----M----X--------
--------------X---E--------------o-----M-----X-----X---X-M-------------X---E----X----T-B----------------------------------------o----M-----?B-----o-o---------oo---o---------B-------o-------o----------
------------------T---------o-X-X---------?--o-Bo---------X----------------X---------|------Mo-o-----oE-----Xo----------o--B--B--X-------------T----------o------E-B---o-------o-------T-XoooE--B-------
------------------|X-X---o---o------?-oo------o---------M---?B----o------------Bo--oX|-oo--o--M-X-oo--BB---------B--o--------------X-----------|B----------------M-------o-oX--o------o|o----?o---------
---------X---o-o--|o---------o-----o------oE---------T-B--o--oB----------------------|--M-------oo------o-M---------------M---o-------BEo-----o|-o?-o--------Xo------oE----o-----oEX--B|--X-------------
-------------o----|----------o--?oB------o-Bo--X---Xo|-------o-o-M-MB---o--o-----E---T-T-oE---------------o----X--o--------M-----------X---X--?|-B--------o---------o-?----M------X---o|M--M----o-------
-------oE---------M---Eo--X-------o------B--o---o----|-------------o-----X---o---X---|-|-BB-----o------------?-----o-----Bo---X--Mo--M---------|---o---o-----------M--E--------------M-|----------o----v
-------oM-------o-----B----?----oX-----E-o-----o-----|-----o-Eo---?---o--o-------X---|-|B---o--M-M-E------------?o-----------o----o------------|----E----o-oE---oB----Bo-M-o----Mo-----|-----M---T-----f
-------B----B----M-E---------o-----Mo-X?-----T-oX----|-------M---?-M---ooo-----------|-|---o-T-----X----o-o----o-B----------------oM----------M|---oB-------B-E--------E-----E------B--|------X--|-----f
----B----o----E----B----------------M-----o--|-------|--?----------------X---X---o--oXM|-----|o---------o--E-------------o---o---E--o--------X-X------B------XXo----MB-To----Bo---o----|B-X---M--|-----f
---o----------B-------------o-------o--o-o---|-E---B-|----o--?o-o-----oB---------------|-----|BoM------M---M---------oo----o-----T-----E-E----o---o---MoM--------------|o----o---------M---o---B-|-----f
---B----oBo--o---X?--ooBoo--o-BB-o---X---oB--|-TB----|--?Xo---X-o-oM-B-----o-o--X--Xo--|-----|-----------oM-X--o-----------o--o--|B----M-XX-B---------o-X---o--o-------|----ooo------------o-----|-----f
--------------o------o-----------------------|-|-----|-------------------o-------------|-----|---o--------oo--o---o------o-------|----------o-------------o-----o------|-----o-o-----------------|-----f
m-----------------o------------o------------E|-|-----|--------E----------o----E--EE--o-|-----|------o-E-E-ooE-----o--------------|o--o--------------------ooE----oEo-o-|----E----o-------o--o-E--|o----X
XX-X-X-XX-XXXXXXXXX-XXXXXXX-XXXX------X---XXX|-|-XX--|-XXX---XXXXX-X-X----XXXXXXXXX--XXXXX-X-|---XXXXXX-XXXXX-XXXXXXXXXXXXXXXX-XXXX-XXXX-XX-X-X--XX-XX-X-XXXXXXXXXXXXX-XXXXXXXXXXXXXXXXXXXXXXXX-XXXXXX-X
