-OO-------O---------O-OOEEO--O-O-O--OO-O---OOO---O---------OOO------O----E-----OEOEO---O-O----E--O--OO----O-O---OO-O-----OO---O-O----------O-OO--O-OO-OEO-----O---E--O-----O-----OO-OO-O--O--O------OO-O
-O--O------O-O--O-EO-O--XTO---EOEBM---OO-B?O-----O--OOOO------O---OOOO--OXOO--O-MM?--O-O-BO---BE---O---OO---O-OM--EMOE--OOT?-XOOOX--O--------M---O---B-T-------BX-BO---OOOE-O--BOO-E-E---OE---O--EOO-OE-
----O---O----OOO-OB--OOM-|O-E-BOB--E---OE---E---E-BO--O---OO----EOMOOO-?OOXBB-BO---OO--OX-B-OO-M-O-?-EXOO--?---O-MXOOB---X|OO--OOOO--OOE-OX--OO-OB--O--|-O---OE-O--?OBMX?-BXBX-OO--T-MB-OMM--OOOOB-O-XBO
----O-O--O-------OOO-O-OO|--BOOOOOEMXM--B--OXB-OX-OOO-X-OET---XXB-X-MOO-O---OOOO--E-------O-X-E-BOOOMB--OOXOO-XEO--O----O-|O--XOO-OO--OXTE---O-OOO--B--|OTO-EMB-E------OOOOO--X-EX-|--O-?-O-X-O-OO--E-O-
----O------O---OB--E-EOO-|BO-M-O-M?---OEO-----XO---O-----T|X-X---O-O-M----OO-OO-O-BOO-E-O--E--BO-O-O--OOM--O?OOT-EOTO-O-EOB-OBOO------B-|X-OM-O-?O---O-|-|-OX---MO--OOOO----O---BMO|M--OOO-E-O-O--O-BOO-
-O----O-O-----OB---MOMXO-|OBO---?-OEO-MX----O--TO-E----?-||OO--O-XOO---X-OMXXE---O-OOBXB---M-OO-O-O--OB--OO--OO|-BB|OTO-XOO-O--------?O-|-OO------BO-XO|E|O-OX-EOO-EOBB--O-OOOOO---|OB-O--OBOOEOOOBO-OX-
------O-O-OOO--XO-M----OB|O---M--O-MOEO-OO-ET--|?-X-XOO--|XOMOOXM-O---B------X-OB--X--O-OOO-XOO--OOX-E---B--OB-|BO-|O|OOOOO-OO-OE-MEOOO-M-OO--OOOM?XXOMBB|O-OOOBOMOB?O-E-----O-----MO-OBEOO-O-XB---OOM-O
---O-OO--OO--XX-BB--?O-X-M---OO---OOOX---?OM|--|OOOO-B--X|OOOOO?XOEXXM-E--O---OM-E--OO-OBOOO-O---O-O-X--X--M--?|---|-|OOXO-OX-MOT--B----OOBB-O-T-O----O-O|OX--X--OOO--OTO--O-OX---------T-OEO---XB---O-v
----OOOO-OO-X--O-OEX--OOOO-OXBOOX------OOOO-|-XX-T-OO--O-|-O--O---M-OOOX-OX-O-OOOXX-X-EO-EBO-OMBBO--M-OBO--O-O-|EXO|-TB?O--O--O-|O-OO?X--X--X-O|?OE------|XM?OO-TOO---X|-OO--O-OMXE-X--O|OEB-OO-OO---O-f
-O-----O---X-OO-E-M--T--X-E-OO-EE-OMOOX---?O|O---|-MO-T--M----T-----O-OOTO--TOX-O-O-OOX--B-O-OOOOO----O-BTO-OB-|MOM|-|---OTXMX--|BX---OXOO-O-EO|OOT-BXMO-|O-OO--|-MBO--|----O---O-XE-BOO|-M--OMOE--E--Bf
----E--B-O-OTX-OME-O-|----BOO-OBBEO--OOOM-OBBOB--|---X|-OO-BMT|XEO-O-O--|---|B-O-OO?-OO-EOO--O----T----OO|OE--E|O-X?-|----|OOXT-|O-ME--OOO-O-BE|-O|-OOX--|-OO-E-|M---?OBE--BOTO----BO-O-|-OM-OOOB--M--Of
---OXBB-BEO-|O--XXO-OBXBOB-MO-B--BM-?------O--O--|T-B-|BB-B--||-XOOE-B-O|OOB|-O--O-O-M-OM-O-ME-O--|EOO-B-|OX--??-XO--|--OO|OO-|-M---M-O--MB--OX|EX|----EEX-TBMB-|O-E--TO?E-OB|-O--O-MO-EXBOOTO--------Ef
--O----O-M-X|OOM-OXO---OOO-OBO-OO--O--B-OOOM-OOB-||T--|--X---|BO--O?M-X-|O--|OTO-XB-XOBO-O-MOTB-B-|B-TM-B?MOO--O--OXX|?OMX|OB-|X-BX--XXMOO-OMO-MX-XXT--BT--|O-OOMO?B--|OOXX-O|--O----XXTO--O|---OBOOB?Xf
-o--o-o-----|---o--------o------------o--o--ooo-o|||-o|-o----|--o---oo--|---|-|--------------|----|o-|---o-----------|---o|---|------o-o-----o------|---|--|---------o|------|-oo------|-o--|--oo------f
m-oo-E------|---o--------o-o-------------o---oo--|||--|o-----|---o-EEoE-|---|-|-----E--------|-E--|--|-------o-E-----|-E-o|---|------oo-o-----o-----|o--|--|------E---|------|-ooE-o---|--E-|-oo-------f
XXXXXXX-----|--XX-------XXXX---------XXXXXXXXXXXXXXXXXXXX----|-XXXXXXXXX|---|-X-----X--------XXX--|XX|---XXXXXXXXXXXXXXX-XX-X-|------XXXXXXXXXX----XXXX-|--|------XXXXX------|-XXXXXX--|XXX-|-XXXX-----X
