XXXXXXXXXXXXXXXXXXXXXXXXXXXXXXXXXXXXXXXXXXXXX
X11111111111111111111111X1111111111111X1111bX
X111122222221111111111111X133111111111X11111X
X1111111111211111111111111X131111X1111X11111X
X1111111c112111111111111111X22222X1111X11111X
XXXXXXXXXXXXX111111111111111X1111X1111X11111X
X1111111111111111111111111111X111X1111X11111X
X11111111111111111111111111111X11X1111111111X
X111111111111111111111111111111XXXXXXXXXXXXXX
X1111111112222222111111111111111111111111111X
X1111111111111111111111111111111111111111111X
X1111111111111111111111111111111111111111111X
X1111111111111111111111111111111111111111111X
X1111111111222111111111111111111111111111111X
X1111111111222111113333333333333333333333333X
X112222211122211111X111111111111111111111111X
X111112131122211111X11d11111111111XXXXXXXXX1X
X111111221111111111X111111111111111Xe3133311X
X111212111111111111X111111111111111X13322211X
X111111111111111111X111111111111111X11133311X
X11a212111111111111X111111111111111X11122211X
XXXXXXXXXXXXXXXXXXXXXXXXXXXXXXXXXXXXXXXXXXXXX